的	dk
一	fi
是	si
不	gn
了	ld
在	zj
人	rl
有	kw
我	wo
他	tl
这	vi
个	gl
们	ml
中	vs
来	lr
上	su
大	dn
为	wn
和	hv
国	gg
地	dj
到	dm
以	kl
说	sf
时	sm
要	kc
就	jt
出	ci
会	hl
可	ks
也	kd
你	nl
对	dh
生	sk
能	nc
而	rr
子	zh
那	ng
得	dp
于	yy
着	vk
下	xu
自	zn
之	vn
年	nn
过	gi
发	fh
后	hs
作	zl
里	lc
用	kb
道	di
行	xp
所	sh
然	ru
家	jj
种	vv
事	sr
成	ck
方	fk
多	dw
经	jd
么	mc
去	qj
法	fe
学	xj
如	rw
都	dg
同	tg
现	xi
当	dja
没	me
动	de
面	mr
起	qu
看	kt
定	dje
天	ty
分	fp
还	hi
进	ji
好	hw
小	xjo
部	bg
其	qh
些	xy
主	vio
样	kk
理	li
心	xo
她	tw
本	bk
前	qp
开	ky
但	dl
因	kg
只	vsu
从	cl
想	xoe
实	sj
日	rm
军	jje
者	vj
意	kr
无	wy
力	le
它	tj
与	yr
长	vne
把	bo
机	jk
十	sa
民	md
第	dy
公	gp
此	ch
已	ka
工	go
使	sl
情	qo
明	mm
性	xou
知	vp
全	ql
三	sy
又	kh
关	gpe
点	du
正	vh
业	ke
外	ww
将	jb
两	lri
高	gt
间	jg
由	km
问	wg
很	hp
最	zm
重	vy
并	bp
物	wk
手	so
应	kso
战	vki
向	xs
头	tn
文	wt
体	tle
政	vu
美	mk
相	xk
见	je
被	bj
利	lv
什	sle
二	ry
等	dye
产	cw
或	hr
新	xh
己	ja
制	vm
身	sn
果	gm
加	jei
西	xc
斯	shu
月	yw
话	hf
合	hle
回	hg
特	tk
代	dle
内	ngu
信	xl
表	by
化	hlu
老	lj
给	gd
世	sie
位	wl
次	cc
度	ds
门	mg
任	rlu
常	cb
先	xku
海	he
通	ti
教	ju
儿	ri
原	yb
东	dr
声	sja
提	to
立	lw
及	jn
比	bn
员	ys
解	jx
水	se
名	mw
真	va
论	lf
处	cu
走	zu
义	kn
各	gu
入	rn
几	jr
口	kse
认	rf
条	tu
平	pr
系	xd
气	qi
题	th
活	heu
尔	rj
更	gr
别	bm
打	do
女	nw
变	bt
四	sg
神	sv
总	zo
何	hlei
电	dma
数	suo
安	rja
少	sju
报	boa
才	cr
结	jde
反	fhu
受	sho
目	mt
太	tno
量	lm
再	zr
感	goe
建	jia
务	wu
做	zle
接	jo
必	bou
场	cj
件	jl
计	jf
管	gy
期	qhu
市	st
直	vai
德	dpe
资	zz
命	mle
山	sp
金	jke
指	vo
克	kai
许	xf
统	td
区	qg
保	bl
至	vje
队	dgu
形	xz
社	sve
便	ble
空	kp
决	jc
治	ve
展	vw
马	mf
科	kv
司	ss
五	wr
基	jh
眼	kta
书	sd
非	fn
则	zzi
听	ts
白	bc
却	qge
界	jru
达	die
光	gj
放	fku
强	qq
即	jv
像	xlu
且	qn
难	nh
权	qk
思	sro
王	wi
象	xm
完	wj
设	sfu
式	soe
色	sma
路	la
记	jfa
南	na
品	ps
住	vl
告	gk
类	lz
求	qr
据	joa
程	cv
北	bne
边	bi
死	sq
张	vq
该	gf
交	jtu
规	ge
万	wra
取	qga
拉	lo
格	gku
望	wio
觉	jjo
术	sko
领	lh
共	gpei
确	qx
传	cle
师	sb
观	gh
清	qe
今	jlo
切	qm
院	yg
让	rfi
识	sfi
候	hli
带	db
导	da
争	vma
运	yi
笑	xyu
飞	fd
风	fj
步	bh
改	ga
收	sua
根	gka
干	gyi
造	zi
言	kf
联	lg
持	co
组	zd
每	mb
济	jeo
车	cd
亲	qw
极	jku
林	lk
服	fw
快	ko
办	be
议	kfo
往	wp
元	yyu
英	ki
士	sje
证	vf
近	jiu
失	sne
转	vd
夫	fy
令	ll
准	vc
布	bb
始	sw
怎	zou
呢	ns
存	che
未	wyi
远	yie
叫	js
台	tc
单	dpi
影	kz
具	jp
罗	ly
字	zja
爱	rh
击	jy
流	leo
备	bu
兵	bpu
连	lie
调	df
深	seo
商	sto
算	syi
质	vz
团	tge
集	jq
百	br
需	xx
价	jlu
花	hiu
党	dii
华	ha
城	cje
石	sx
级	jdu
整	vhe
府	fs
离	lt
况	kci
亚	kee
请	qf
技	joe
际	jge
约	yd
示	svo
复	fu
病	ba
息	xn
究	jpu
线	xde
似	sla
官	gji
火	hu
断	dho
精	jz
满	mee
支	vaa
视	svi
消	xe
越	yu
器	qs
容	rp
照	vui
须	xze
九	jna
增	zjo
研	kx
写	xje
称	cvu
企	qli
八	bpo
功	goa
吗	ms
包	bd
片	pd
史	ssu
委	wv
乎	hn
查	cki
轻	qd
易	kmu
早	zme
曾	cp
除	cg
农	nj
找	voe
装	vjo
广	gs
显	xmi
吧	bs
阿	rg
李	lka
标	bke
谈	tf
吃	cs
图	tgu
念	no
六	ltu
引	kq
历	lb
首	spe
医	kgu
局	jw
突	tp
专	vya
费	fz
号	hse
尽	jwo
另	ls
周	vg
较	jdo
注	veo
语	yf
仅	jla
考	kj
落	lio
青	qc
随	sge
选	xiu
列	lq
武	wh
红	hd
响	xsu
虽	ssi
推	tou
势	see
参	cce
希	xb
古	gai
众	vlu
构	gkua
房	fa
半	bnu
节	jiai
土	tje
投	toua
某	mi
案	rk
黑	hro
维	wd
革	gii
划	hk
敌	duu
致	vue
陈	cge
律	lp
足	za
态	toe
护	ho
七	qra
兴	xjeu
派	pe
孩	hh
验	kfu
责	zze
营	kio
星	xmu
够	gdi
章	vr
音	kre
跟	gaa
志	vjoa
底	dsu
站	vwi
严	kbe
巴	bdi
例	lle
防	fg
族	zk
供	gle
效	xuo
续	xdei
施	sku
留	lru
讲	jfe
型	xjee
料	lzo
终	vdu
答	dyu
紧	jdi
黄	hpe
绝	jdua
奇	qne
察	cju
母	mbo
京	jti
段	dd
依	klo
批	po
群	qka
项	xoeu
故	gue
按	ro
河	hee
米	mz
围	wge
江	jee
织	vdi
害	hj
斗	ddi
双	sha
境	jjoe
客	kju
纪	jda
采	chei
举	jjeu
杀	skuo
攻	gou
父	fl
苏	sia
密	mp
低	dlu
朝	cwe
友	khe
诉	sfuu
止	vhee
愿	yo
细	xdi
千	qa
值	vle
仍	rla
男	nr
钱	qke
破	px
网	wgu
热	rue
助	vei
倒	dlea
育	yt
属	swu
坐	zju
帝	dt
限	xg
船	ccu
脸	lwu
职	vgi
速	siei
刻	kmo
乐	lju
否	fse
刚	gmi
威	wke
毛	mv
状	vb
率	lta
甚	shaa
独	dfi
球	qie
般	bcu
普	pp
怕	pou
弹	dq
校	xko
苦	kie
创	cm
假	jlae
久	jnao
错	cke
承	cdi
印	kgua
晚	wm
兰	lpe
试	sfe
股	gw
拿	nle
脑	nwo
预	yh
谁	sfui
益	kpe
阳	kgi
若	rie
哪	nsa
微	wpi
尼	nwu
继	jdou
送	sio
急	jou
血	xr
惊	joo
伤	slu
素	sde
药	kia
适	siu
波	bea
夜	ktu
省	sti
初	cja
喜	xji
卫	wgee
源	ye
食	sso
险	xgu
待	dpei
述	sieiu
陆	lge
习	xca
置	vye
居	jwe
劳	lee
财	cz
环	hie
排	poi
福	fv
纳	nd
欢	hhu
雷	lx
警	jfei
获	hiua
模	mke
充	ct
负	fm
云	yya
停	tlo
木	mko
游	keo
龙	ldo
树	ska
疑	kau
层	cwee
冷	lcu
洲	veou
冲	cci
射	snei
略	lrua
竟	jrua
范	fio
句	jdia
室	sjea
异	kae
激	jeu
汉	hea
村	ckei
哈	hsu
演	keoo
策	cy
简	jyo
卡	ku
罪	zy
判	pm
担	doi
州	vnu
静	jcu
退	tia
既	jve
衣	kjo
您	nou
宗	zje
积	jvi
余	yl
痛	ta
检	jkuo
差	ckeie
富	fje
灵	lgo
协	xa
角	jxi
占	vuia
配	pc
征	vpe
修	xli
皮	pg
挥	hoo
胜	swue
降	jgu
阶	jguo
审	sji
沉	ce
坚	jji
善	skou
妈	mwa
刘	lti
读	dfe
啊	rs
超	cua
免	mmi
压	kbei
银	kka
买	mn
皇	hc
养	kpee
伊	kla
怀	hoe
执	vou
副	fme
乱	lja
抗	koo
犯	ff
追	viu
帮	bbe
宣	xjei
佛	fla
岁	spu
航	hco
优	kle
怪	goao
香	xv
著	vie
田	tr
铁	tku
控	kooo
税	svou
左	zoe
右	kseu
份	flu
穿	cpe
艺	kiaa
背	bw
阵	vge
草	cii
脚	jwei
概	gkae
恶	roe
块	kja
顿	dhe
敢	gua
守	sjei
酒	jeei
岛	dpu
央	kni
托	toue
户	hau
烈	lu
洋	keou
哥	gse
索	sao
胡	hwe
款	kke
靠	kki
评	pf
版	bdu
宝	bje
座	zs
释	sno
景	jm
顾	ghe
弟	dpa
登	djei
货	hz
互	hra
付	fle
伯	blu
慢	mo
欧	rke
换	hou
闻	wgei
危	wme
忙	moo
核	hko
暗	rmo
姐	jwi
介	jlui
坏	hje
讨	tfe
丽	lria
良	lvo
序	xsa
升	siue
监	jri
临	ln
亮	ltia
露	lxi
永	kna
呼	hsuo
味	ws
野	kca
架	jka
域	yj
沙	sei
掉	doie
括	kou
舰	jci
鱼	yc
杂	zku
误	wf
湾	we
吉	jjia
减	jce
编	bdo
楚	ca
肯	khi
测	cei
败	bz
屋	wwe
跑	pa
梦	mwe
散	sue
温	wei
困	kge
剑	jmu
渐	jeea
封	fpe
救	jue
贵	gz
枪	qku
缺	qja
楼	lko
县	xci
尚	sjia
毫	ht
移	kvu
娘	nwoa
朋	pw
画	hri
班	bio
智	vmu
亦	ktui
耳	rge
恩	roi
短	dpeia
掌	voi
恐	koe
遗	kii
固	gge
席	xse
松	skuoa
秘	mvo
谢	xfu
鲁	lci
遇	yii
康	ksa
虑	lro
幸	xjou
均	jju
销	xki
钟	vkia
诗	sfei
藏	cie
赶	guee
剧	jma
票	pce
损	soi
忽	houa
巨	jga
炮	pu
旧	jmi
端	dwi
探	too
湖	heei
录	lgi
叶	ksei
春	cme
乡	xda
附	fgu
吸	xsua
予	ydo
礼	lva
港	gee
雨	yx
呀	ksea
板	bku
庭	tsu
妇	fwa
归	ggi
睛	jte
饭	fsu
额	rhi
含	hlo
顺	shui
输	sdu
摇	kouo
招	voa
婚	hwu
脱	two
补	bji
谓	wfi
督	dti
毒	dbe
油	kei
疗	laa
旅	lku
泽	ze
材	ckeiu
灭	mu
逐	vieu
莫	mii
笔	byu
亡	wta
鲜	xco
词	cf
圣	she
择	zoa
寻	xge
厂	cbu
睡	stu
博	bae
勒	lia
烟	kui
授	sou
诺	nf
伦	llu
岸	rpe
奥	rnu
唐	tsa
卖	ma
俄	rlue
炸	vuu
载	zde
洛	leu
健	jlaee
堂	tji
旁	pt
宫	gjia
喝	hsi
借	jle
君	jsa
禁	jvei
阴	kguae
园	yge
谋	mfe
宋	sjeiu
避	bia
抓	vouu
荣	rkei
姑	gwe
孙	shi
逃	tiu
牙	kra
束	sri
跳	tau
顶	dhei
玉	yio
镇	vke
雪	xxa
午	wne
练	lde
爷	klai
迫	pi
篇	py
肉	rgu
嘴	zsi
馆	gso
遍	bioa
凡	fr
础	cx
洞	dei
卷	jpe
坦	tjia
牛	nk
宁	nje
纸	vdua
诸	vfe
训	xfui
私	sva
庄	vse
祖	zv
丝	sra
翻	fq
暴	bme
森	ske
塔	tjei
默	mre
握	woa
戏	xhe
隐	kguaa
熟	suoe
骨	gne
访	ffo
弱	rq
蒙	mq
歌	gke
店	dsi
鬼	ggo
软	rd
典	dpia
欲	yk
萨	siai
伙	hlou
遭	zie
盘	pci
爸	bla
扩	kooe
盖	gki
弄	ni
雄	xq
稳	wvu
忘	woo
亿	klaa
刺	cmei
拥	koua
徒	tpe
姆	mwaa
杨	kkau
齐	qt
赛	sz
趣	que
曲	qmi
刀	dmu
床	cse
迎	kiu
冰	bci
虚	xri
玩	wie
析	xkuu
窗	cpu
醒	xcia
妻	qwe
透	tiue
购	gzu
替	tm
塞	sjo
努	ne
休	xle
虎	hru
扬	koa
途	tiuo
侵	qla
刑	xme
绿	lda
兄	xsuaa
迅	xia
套	tne
贸	mzu
毕	bnei
唯	wsu
谷	gsu
轮	ldu
库	kseae
迹	jio
尤	kwo
竞	jwia
街	jpei
促	cli
延	kiui
震	vx
弃	qta
甲	jmii
伟	wle
麻	mro
川	cn
申	smi
缓	hdu
潜	qee
闪	sgu
售	sqi
灯	due
针	vkei
哲	vsei
络	ldua
抵	dou
朱	vnee
埃	rjao
抱	boua
鼓	gjiae
植	vkeii
纯	cde
夏	xue
忍	roa
页	kho
杰	jko
筑	vyei
折	vouue
郑	vgo
贝	bzo
尊	zp
吴	wse
秀	xva
混	hei
臣	cgi
雅	kqe
振	voeu
染	rko
盛	sre
怒	noa
舞	wnee
圆	ygi
搞	goo
狂	kfe
措	coe
姓	xw
残	cq
秋	qv
培	pj
迷	mio
诚	cfe
宽	kje
宇	yje
猛	mfa
摆	boi
梅	mku
毁	hdui
伸	sli
摩	mooe
盟	mri
末	my
乃	ndu
悲	boie
拍	poui
丁	dri
赵	vuuo
硬	kxe
麦	mge
蒋	jioe
操	coi
耶	kga
阻	zg
订	dfei
彩	czu
抽	coia
赞	zzu
魔	mgo
纷	fdu
沿	keu
喊	hseu
违	wiee
妹	mwee
浪	leoa
汇	heea
币	bbu
丰	fye
蓝	lii
殊	squ
献	xfe
桌	vuiae
啦	lse
瓦	wwo
莱	lieo
援	you
译	kfa
夺	dne
汽	qeu
烧	suea
距	jae
裁	cjei
偏	pl
符	fyu
勇	kea
触	cxi
课	kfi
敬	juei
哭	kfia
懂	doe
墙	qje
召	vmi
袭	xdo
罚	fyo
侠	xleo
厅	tb
拜	boe
巧	qoe
侧	clia
韩	hq
冒	mmia
债	vlee
曼	mmiai
融	rhe
惯	goaa
享	xt
戴	dke
童	twi
犹	kfeu
乘	cne
挂	goei
奖	jno
绍	sda
厚	hb
纵	zdu
障	vgoe
讯	xfa
涉	seie
彻	cpea
刊	kme
丈	vru
爆	bui
乌	wna
役	kpu
描	moe
洗	xeu
玛	mia
患	hoi
妙	mwi
镜	jkoe
唱	csi
烦	fue
签	qy
仙	xlia
彼	bpa
弗	fqu
症	vae
仿	flo
倾	qle
牌	pdu
陷	xgua
鸟	nt
轰	hda
咱	zsu
菜	ciu
闭	bge
奋	fni
庆	qse
撤	coo
泪	lei
茶	ciuo
疾	jau
缘	yda
播	bouo
朗	lwo
杜	dkei
奶	nwa
季	jva
丹	dgo
狗	gfu
尾	wwu
仪	klou
偷	tlu
奔	bneie
珠	viue
虫	cho
驻	vfo
孔	kha
宜	kji
艾	riu
桥	qkue
淡	deo
翼	kqi
恨	hoa
繁	fdue
寒	hjee
伴	blo
叹	tsao
旦	dme
愈	youo
潮	cee
粮	lzoa
缩	sdo
罢	bye
聚	jgao
径	jpa
恰	qou
挑	touo
袋	dju
灰	hue
捕	boei
徐	xpu
珍	viuo
幕	mbe
映	kmi
裂	lje
泰	te
隔	ggei
启	qai
尖	jjeuo
忠	voia
累	lra
炎	kuo
暂	zmea
估	glei
泛	feu
荒	hio
偿	clio
横	hke
拒	joea
瑞	rii
忆	koaa
孤	ghu
鼻	bii
闹	ngo
羊	kkii
呆	dse
厉	lbe
衡	hpu
胞	bwu
零	lxu
穷	qpa
舍	slee
码	mx
赫	hiei
婆	pwo
魂	hge
灾	zjou
洪	heeii
腿	twa
胆	dwia
津	jea
俗	sluo
辩	bbo
胸	xwu
晓	xmea
劲	jeao
仁	rle
贫	pz
偶	rli
辑	jdiae
邦	bgee
恢	hoeu
赖	lze
圈	qgo
摸	moei
仰	klu
润	re
堆	djui
碰	pxo
艇	tcu
稍	svio
迟	cia
辆	ldei
废	fsa
净	jcua
凶	xguo
署	sye
壁	bja
御	yp
奉	fyeu
旋	xkue
冬	duo
矿	kxo
抬	toa
蛋	dai
晨	cmeu
伏	fleu
吹	csu
鸡	jhu
倍	bloe
糊	hze
秦	qve
盾	dtu
杯	bkeu
租	zvi
骑	qfe
乏	fno
隆	lgu
诊	vfu
奴	nwao
摄	soei
丧	saou
污	wee
渡	deoe
旗	qkuee
甘	gie
耐	np
凭	pru
扎	voaa
抢	qouo
绪	xdeie
粗	czi
肩	jai
梁	lkoo
幻	hdao
菲	fii
皆	jnu
碎	sxo
宙	vji
叔	shie
岩	kpeu
荡	dio
综	zdo
爬	ph
荷	hiui
悉	xouo
蒂	dioe
返	fiu
井	jyu
壮	vbe
薄	bioo
悄	qoi
扫	soa
敏	muu
碍	rx
殖	vqe
详	xfo
迪	diia
矛	mdo
霍	hx
允	ycu
幅	fb
撒	soeii
剩	smu
凯	kri
颗	khia
骂	mfi
赏	szi
液	keoe
番	fru
箱	xye
贴	tz
漫	mei
酸	sc
郎	lgoa
腰	kwe
舒	sleei
眉	mta
忧	koeu
浮	feuo
辛	xbi
恋	loo
餐	csie
吓	xsei
挺	touei
励	leeu
辞	cjo
艘	scu
键	jkae
伍	wlei
峰	fpu
尺	cwo
昨	zmu
黎	leue
辈	bdie
贯	gb
侦	vli
滑	heia
券	qmo
崇	cpo
扰	roeu
宪	xju
绕	rde
趋	quu
慈	coou
乔	qneu
阅	ygo
汗	heee
枝	vkeia
拖	touea
墨	mrei
胁	xwa
插	cou
箭	jyou
腊	lwe
泥	nea
粉	fzu
氏	sna
彭	pze
拔	boeu
骗	pfo
凤	fra
慧	hoee
媒	mwei
佩	plu
愤	fo
扑	poio
龄	lfu
驱	qfeu
惜	xoei
掩	koeuo
豪	hti
兼	jpea
跃	ya
尸	swuu
肃	sgi
帕	pb
驶	sfia
堡	bju
届	jwiae
欣	xhu
惠	hoei
册	cru
储	clo
飘	pje
桑	skao
闲	xgei
惨	coa
洁	jeeie
踪	zao
勃	bee
宾	bjui
频	phi
仇	clu
磨	mxo
递	diou
邪	xgea
撞	voo
拟	noao
滚	geo
奏	zye
巡	xiaa
颜	khoe
剂	jmo
绩	jdee
贡	goi
疯	fau
坡	pja
瞧	qtu
截	jqe
燃	ruu
焦	jqo
殿	dda
伪	wlo
柳	lkua
锁	ski
逼	bie
颇	pge
昏	hm
劝	qha
呈	csee
搜	soui
勤	qeei
戒	jkee
驾	jfau
漂	pee
饮	ksu
曹	cmeia
朵	dre
仔	zla
柔	rka
俩	llei
孟	mh
腐	fsui
幼	keaa
践	jaee
籍	jye
牧	mkue
凉	lco
牲	skue
佳	jlei
娜	nwae
浓	neo
芳	fioe
稿	gv
竹	vnei
腹	fwu
跌	dau
逻	liia
垂	cyu
遵	zio
脉	mwo
貌	mgu
柏	bkui
狱	yfo
猜	cfee
怜	lou
惑	hoeia
陶	tgua
兽	spi
帐	vbu
饰	ssue
贷	dz
昌	cmi
叙	xhuo
躺	tni
钢	gkia
沟	geu
寄	jjeuoe
扶	foe
铺	pk
邓	dha
寿	spee
惧	joi
询	xfua
汤	tea
盗	dro
肥	fwai
尝	cjoa
匆	cdu
辉	hjeu
奈	nne
扣	koi
廷	tiuei
澳	reu
嘛	mso
董	diu
迁	qiu
凝	ncu
慰	woae
厌	kbeu
脏	zw
腾	twou
幽	knaa
怨	youa
鞋	xie
丢	dc
埋	mj
泉	qci
涌	keao
辖	xdoo
躲	dnu
晋	jme
紫	zdi
艰	jha
魏	wgue
吾	wsei
慌	hoeii
祝	vvi
邮	kgia
吐	tse
狠	hfa
鉴	jki
曰	ym
械	xke
咬	ksoe
邻	lguo
赤	cio
挤	jooe
弯	wq
椅	kkeu
陪	pgo
割	gmo
揭	joia
韦	wqi
悟	woe
聪	cgo
雾	wx
锋	fkua
梯	tko
猫	mfei
祥	xvo
阔	kgo
誉	yfoo
筹	cye
丛	cruo
牵	qno
鸣	msu
沈	seoa
阁	ggu
穆	mvu
屈	qwa
旨	vmua
袖	xjia
猎	lfe
臂	bwa
蛇	shoo
贺	hza
柱	vko
抛	poua
鼠	spa
瑟	siee
戈	gko
牢	ljue
逊	xiai
迈	mie
欺	qhua
吨	dsea
琴	qiee
衰	stia
瓶	pwou
恼	noo
燕	kue
仲	vlia
诱	kfue
狼	lfo
池	cea
疼	taua
卢	lua
仗	vleu
冠	gje
粒	lzoe
遥	kiuo
吕	lsi
玄	xta
尘	cjeie
冯	fc
抚	foee
浅	qeee
敦	duoe
纠	jdai
钻	zki
晶	jmia
岂	qpae
峡	xpe
喷	pse
苍	ciuoa
凌	lce
耗	hy
敲	qro
菌	jii
赔	pzo
涂	teu
粹	czo
扁	bai
亏	kya
寂	jjie
煤	mue
熊	xua
恭	goeii
湿	seia
循	xpuu
暖	nm
糖	tzo
赋	fze
抑	kouaa
秩	vvu
帽	mbi
哀	rt
宿	sjui
踏	tai
烂	luo
袁	yji
侯	hla
抖	doo
夹	jro
昆	kmea
肝	gwee
擦	cooo
猪	vfei
炼	lue
恒	hoeiae
慎	soeiia
搬	bouu
纽	nda
纹	wdo
玻	biau
渔	yeu
磁	cxo
铜	tki
齿	cfi
跨	kaeu
押	koia
怖	boeui
漠	meei
疲	paa
叛	ppe
遣	qii
兹	zpe
祭	jvu
醉	zc
拳	qoo
弥	mqu
斜	xdu
档	dki
稀	xvu
捷	joeae
肤	fwe
疫	kaua
肿	vwia
豆	djee
削	xmio
岗	gpi
晃	hmi
吞	tsee
宏	hjeua
癌	ra
肚	dwe
隶	lgio
履	lwuu
涨	vea
耀	kjeu
扭	noai
坛	tjee
拨	boau
沃	weu
绘	hduo
伐	flea
堪	kjei
仆	pli
郭	ggoe
牺	xkei
歼	jqu
墓	mje
雇	gau
廉	lso
契	qnee
拼	poo
惩	couu
捉	voiae
覆	fcu
刷	smae
劫	jeeiea
嫌	xwo
瓜	gdo
歇	xkia
雕	dqu
闷	mgoa
乳	rha
串	csia
娃	wwei
缴	jdui
唤	hsua
赢	kzo
莲	liea
桃	tkuo
霸	bx
妥	tha
瘦	sau
搭	doei
赴	fui
岳	ypu
嘉	jjiae
舱	ccuo
俊	jlao
址	vjie
庞	pseu
耕	gye
锐	rkou
缝	fdua
悔	houe
邀	kiuia
玲	liu
惟	wou
宅	vju
斥	choo
添	tee
挖	wooo
呵	hsei
讼	sfuo
氧	kiou
浩	heue
羽	yq
斤	jhi
酷	kcu
掠	looe
妖	kwu
祸	hvi
侍	slei
乙	kda
妨	fwo
贪	tzu
挣	voua
汪	weee
尿	nwi
莉	liue
悬	xoi
唇	cni
翰	hai
仓	cla
轨	gdu
枚	mkueu
盐	krei
览	leii
傅	flei
帅	sbi
庙	msi
芬	fiuo
屏	pwoue
寺	sjeio
胖	pwouee
璃	lioe
愚	yoi
滴	deoeo
疏	saoe
萧	xiae
姿	zwo
颤	choe
丑	cdie
劣	ljua
柯	kkei
寸	cpoo
扔	roau
盯	dte
辱	rne
匹	pgu
俱	jli
辨	bbou
饿	rsu
蜂	fhua
哦	rsue
腔	qwo
郁	ygeu
溃	keia
糟	zzei
谨	jfeii
葛	giia
苗	miia
肠	cwa
忌	jao
溜	leua
鸿	heeie
爵	jhia
鹏	ptu
鹰	ksui
笼	lye
丘	qni
桂	gkei
滋	zeo
聊	lgua
挡	doio
纲	gdia
肌	jwu
茨	cioe
壳	kjoa
痕	haa
碗	wxo
穴	xpo
膀	bwo
卓	vuiaee
贤	xzi
卧	wue
膜	mweii
毅	kdo
欠	qko
锦	jkui
哩	lsia
函	hga
茫	mioo
昂	rmu
薛	xiui
皱	vgu
夸	kne
豫	ydoa
胃	wri
舌	sjee
剥	bma
傲	rlee
拾	souo
窝	wpia
睁	vt
携	xoui
陵	lgei
哼	hso
棉	mkui
晴	qme
铃	lkuo
填	tjeii
饲	ssa
吻	wsua
渴	keiae
扮	bouoa
逆	nio
脆	cwu
喘	csiai
罩	vyi
卜	buo
炉	luoa
柴	ckie
愉	youoe
绳	sdi
胎	twao
蓄	xio
眠	mtae
竭	jwiaee
喂	wsi
傻	slui
慕	moeii
浑	heo
奸	jwee
扇	saa
柜	gkea
悦	yoo
拦	loou
诞	dfu
饱	bsu
乾	qaia
泡	peu
贼	zzee
亭	tt
夕	xwoo
爹	dlua
酬	cco
儒	rleo
姻	kwi
卵	lna
氛	fiuoa
泄	xee
杆	gkee
挨	roao
僧	slo
蜜	mho
吟	ksuo
猩	xfi
遂	siou
狭	xfeo
肖	xjiae
甜	tjeiie
霞	xxae
驳	bf
裕	yju
顽	whe
於	yku
摘	vooe
矮	rpu
秒	mvi
卿	qgu
畜	cro
咽	ksi
披	poa
辅	fde
勾	gda
盆	pruo
疆	jqei
赌	dze
塑	sjou
畏	wre
吵	csiu
囊	nri
嗯	rsi
泊	peui
肺	fwei
骤	vfeii
缠	cdo
冈	gguo
羞	xka
瞪	dta
吊	dsia
漏	lea
贾	jcia
斑	bioe
涛	teee
悠	koui
鹿	lfa
俘	fluo
锡	xkiae
卑	bau
葬	zieu
铭	mkua
滩	teao
嫁	jwoo
催	cliai
璇	xioe
翅	cqe
盒	hleia
蛮	mhoe
矣	kcue
潘	peuo
歧	qhe
赐	czia
锅	gkiae
鲍	bcua
廊	lsoa
拆	couue
灌	geei
勉	meu
盲	mto
宰	zjoe
佐	zleu
啥	ssuo
胀	vwu
扯	coie
禧	xve
辽	liai
抹	moee
筒	tyi
棋	qkei
裤	kjoe
唉	rsa
朴	pki
咐	fsuie
孕	yha
誓	sfeie
喉	hsui
妄	wwoe
拘	joua
链	lke
驰	cfa
栏	lkou
逝	sieie
窃	qpe
艳	kye
纤	xdue
臭	cneu
玑	jiua
棵	kkia
趁	cuu
匠	jguu
盈	krau
翁	wqu
愁	coue
瞬	stuo
婴	kwia
孝	xjua
颈	jhao
倘	tli
浙	vee
谅	lfoe
蔽	biou
畅	cmia
赠	zzo
妮	nwaeu
莎	sioo
尉	wpa
冻	dce
跪	gaua
闯	cga
葡	piu
後	hpa
厨	cbe
鸭	kti
颠	dheii
遮	vioe
谊	kfoo
圳	vjui
吁	yse
仑	llua
辟	pba
瘤	lau
嫂	swui
陀	tgo
框	kkee
谭	tfei
亨	htia
钦	qkua
庸	ksae
歉	qkou
芝	vioa
吼	hsa
甫	fri
衫	sjuu
宴	kjia
摊	toao
嘱	vsa
衷	vti
娇	jwue
陕	sgeo
浦	peei
矩	jpeae
讶	kfea
耸	sguo
裸	lji
碧	bxe
摧	coiai
薪	xioeo
淋	leei
耻	cgie
胶	jwoe
屠	twe
鹅	rtu
盼	ptuo
饥	jsu
脖	bwe
虹	hhe
翠	cqo
崩	bpua
账	vzu
萍	pio
逢	fiua
赚	vzo
撑	coio
翔	xkao
倡	cliae
绵	mdu
枯	kkeii
猴	hfu
巫	wriu
昭	vmau
怔	voei
渊	yeuo
凑	ccee
溪	xeuo
蠢	chee
禅	cvo
阐	cgou
旺	wmee
寓	yjia
藤	tiua
伞	slou
匪	fgi
碑	bxu
挪	noae
琼	qio
脂	vwua
谎	hfe
慨	koae
菩	pioe
萄	tiuau
狮	sfiu
掘	joae
抄	coiu
岭	lpu
晕	ymo
砍	kxu
逮	dia
掏	touau
狄	dfo
晰	xmei
罕	hju
挽	woua
脾	pwu
舟	vco
痴	cau
蔡	ciua
剪	jmou
脊	jwoeu
弓	gq
懒	loe
叉	chooo
喃	nse
拐	goia
僚	lleu
捐	joiae
姊	zwu
骚	sfa
拓	toeu
歪	wheu
粘	vzi
柄	bkei
坑	kjoeu
陌	mgeu
窄	vpu
湘	xeei
兆	vno
崖	kpeue
骄	jfu
刹	smuo
鞭	biu
芒	mioe
筋	jyua
聘	pgi
棍	gkiaee
钩	gkuaa
嚷	rso
腺	xwui
弦	xqo
焰	kuu
耍	swe
俯	floe
厘	lbi
愣	loi
厦	sbe
恳	koaee
饶	rse
钉	dkeii
寡	gjeu
憾	hoeue
摔	soo
叠	dhao
惹	roei
喻	ysu
谱	pfou
愧	kouia
煌	huu
徽	hpi
溶	reo
坠	vja
煞	suu
巾	jbi
滥	leiiu
洒	seei
堵	djeie
瓷	cwoe
咒	vri
姨	kwea
棒	bkee
郡	jgae
浴	yeuou
媚	mwai
稣	scue
淮	heui
哎	rsei
屁	pwe
漆	qeeiu
淫	keuo
巢	chi
吩	fsuo
撰	voae
啸	xsae
滞	veei
玫	miu
硕	sxe
钓	dku
蝶	dheiie
膝	xwe
姚	kwuo
茂	mieu
躯	qneuo
吏	lriae
猿	yfe
寨	vkoo
恕	soau
渠	qkoo
戚	qkeu
辰	cno
舶	bcui
颁	bhu
惶	houi
狐	hfuu
讽	ffu
笨	byei
袍	pju
嘲	csei
啡	fsi
泼	pea
衔	xpue
倦	jlou
涵	heai
雀	qju
旬	xdia
僵	jleia
撕	soeiie
肢	vwe
垄	ldeie
夷	krae
逸	kiua
茅	miao
侨	qlu
舆	ypui
窑	kpue
涅	nei
蒲	pioo
谦	qfo
杭	hkoe
噢	rsui
弊	bioui
勋	xei
刮	gjii
郊	jgo
凄	qce
捧	poe
浸	jeae
砖	vxe
鼎	dtae
篮	lyi
蒸	via
亩	mti
饼	bso
肾	swi
陡	dge
爪	vho
兔	tmi
殷	kdu
贞	vuiau
哑	kseii
荐	jie
炭	tpeu
坟	fjo
眨	vtu
搏	boeia
咳	hsoe
拢	loeu
舅	jciae
昧	mme
擅	sooe
爽	sru
咖	ksau
搁	gooi
禄	lvae
雌	cqi
哨	ssio
巩	goua
绢	jdiaei
螺	lhi
裹	gti
昔	xmeii
轩	xdee
谬	mfao
谍	dfeii
龟	gmia
媳	xwuia
姜	jkau
瞎	xto
冤	yjua
鸦	kte
蓬	piua
巷	xae
琳	liei
栽	zke
沾	veie
诈	vfue
斋	vte
瞒	mte
彪	bzi
厄	rb
咨	zso
纺	fdo
罐	gjei
桶	tka
壤	rjo
糕	gzo
颂	shuo
膨	pwei
谐	xfea
垒	ljao
咕	gsei
隙	xgi
辣	lbei
绑	bde
宠	cjeu
嘿	hsia
兑	dpiae
霉	mxu
挫	couo
稽	jveu
辐	fdei
乞	qnea
纱	sdiu
裙	qjae
嘻	xseie
哇	wseie
绣	xduei
杖	vkeu
塘	tjo
衍	kpo
轴	vdia
攀	poei
膊	bwei
譬	pfa
斌	bte
祈	qvu
踢	taia
肆	sjae
坎	kjua
轿	jdue
棚	pku
泣	qeo
屡	lwou
躁	zai
邱	qgui
凰	hrui
溢	keoue
椎	cku
砸	zx
趟	tui
帘	lpi
帆	fbu
栖	qkeia
窜	cpi
丸	wnao
斩	vduu
堤	dji
塌	tjiae
厢	xbe
贩	fzuu
掀	xouu
喀	ksoo
乖	gnei
谜	mfo
捏	noi
阎	kguau
滨	beo
虏	lrau
匙	sme
芦	lioa
苹	pie
卸	xgue
沼	veau
钥	kku
株	vku
祷	dv
剖	pmo
熙	xuei
劈	pma
哗	hsuiu
怯	qoei
棠	tkio
胳	gwu
桩	vkoe
瑰	giu
娱	ywi
娶	qwei
沫	meee
嗓	ssao
蹲	dao
淘	teua
焚	fuei
嫩	nwe
韵	yru
匈	xduo
衬	cjeio
竖	swii
钧	jkua
峻	jpao
豹	bgu
捞	loei
菊	jiuao
鄙	bgi
魄	pcu
兜	diui
哄	hseii
颖	khu
镑	bko
屑	xwi
蚁	khou
壶	hjo
怡	koao
渗	sea
秃	tv
迦	jiau
旱	hme
哟	ksaa
咸	xkeu
焉	kuei
宛	wju
谴	qfi
稻	dvu
铸	vkee
伽	gla
锻	dkui
詹	vme
毙	bneu
恍	hoio
贬	bzu
烛	vuiaei
骇	hfo
芯	xioa
汁	veeii
桓	hkei
坊	fjoe
驴	lfoa
朽	xkea
靖	jweei
佣	klua
汝	rea
碌	lxa
迄	qiue
冀	jpi
荆	jmei
崔	cpui
雁	kbu
绅	sdia
珊	siua
榜	bkoe
诵	sfao
傍	bloeo
彦	kto
醇	ccoe
笛	dyi
禽	qlo
勿	wdu
娟	jwiaei
瞄	mtei
幢	cbo
寇	kjee
睹	dtei
贿	hzeu
踩	cauo
霆	tx
呜	wsuaa
拱	goeiie
妃	fwae
蔑	miiai
谕	yfu
缚	fdeia
诡	gfua
淹	keeu
篷	pyu
腕	wwoo
煮	vuei
倩	qlee
卒	zt
勘	keei
馨	xja
逗	diei
甸	ddia
贱	jze
炒	cui
灿	cuia
敞	cuio
蜡	lhe
囚	qguo
栗	lcei
辜	gaia
垫	djeieu
妒	dwo
魁	kgoo
谣	kfuo
寞	mjei
甩	swa
蜀	syu
枕	vkoa
涯	keeue
丐	gri
泳	keoa
奎	knei
泌	meo
逾	yiu
叮	dsei
黛	dru
燥	zui
掷	voou
憎	zoo
枢	skeu
藉	jiee
鲸	jco
弘	hqa
倚	kleu
侮	wlu
藩	fioo
拂	foa
鹤	hto
蚀	ssia
浆	jeoe
芙	fie
垃	ljo
烤	kueie
晒	smei
霜	sxei
剿	jmaa
蕴	yia
圾	jjua
屿	ype
绸	cdua
氢	qia
驼	tfo
妆	vba
捆	koiae
铅	qkuai
逛	giua
淑	seiee
榴	lkuao
丙	bri
痒	kao
钞	ckiu
蹄	tao
犬	qfoo
躬	gna
昼	vwo
藻	zioo
蛛	vhu
褐	hji
颊	jhe
奠	dno
募	meeii
耽	dgoa
蹈	dauo
陋	lgeia
侣	lli
魅	mgee
岚	lpua
侄	vlea
虐	nre
堕	djai
陛	bgea
莹	kiei
荫	kiai
狡	jfo
阀	fgui
绞	jdoe
垮	kjeuo
膏	gtia
茎	jiao
缅	mde
喇	lsei
绒	rdee
搅	jooo
凳	dra
梭	skaou
丫	knu
姬	jweii
诏	vfa
钮	nka
棺	gkoo
耿	ggou
缔	ddo
懈	xoua
嫉	jwoeuo
灶	zue
匀	ydoe
嗣	ssiae
鸽	gtu
澡	zei
凿	zeou
纬	wde
沸	fea
刃	rmoo
畴	cre
遏	riia
烁	suua
嗅	xsui
叭	bsuo
熬	ruee
瞥	pto
骸	hno
奢	sneie
拙	voai
栋	dkea
毯	tvo
桐	tkia
砂	sxi
泻	xeo
莽	mieuo
坪	pjeo
梳	skoe
晤	wmei
杉	skuu
稚	vvui
蔬	siaie
蝇	khiae
捣	doua
顷	qhea
麽	mru
尴	gwi
镖	bkeia
尬	gwuo
诧	cfo
硫	lxo
嚼	jsuo
羡	xkoe
沦	leuo
沪	heoa
旷	kmoe
彬	bkeiu
芽	kiea
冥	mji
狸	lfi
碳	txi
咧	lseu
惕	toi
暑	smeie
咯	gsua
萝	liiai
汹	xeuoa
腥	xwia
窥	kpeeu
俺	rleu
潭	teei
崎	qpeu
麟	lfou
捡	jouo
厥	jbo
拯	voaia
澄	ceao
哉	zse
萎	wiu
涡	weia
滔	teuo
暇	xma
溯	seou
鳞	lcou
酿	nco
愕	roia
茵	kiia
暮	mmei
瞅	ctu
衙	kpei
诫	jfee
斧	fluu
兮	xpea
焕	huua
棕	zko
佑	kleui
嘶	sse
妓	jweia
喧	xso
蓉	rio
删	smua
樱	kkiau
伺	clae
嗡	wsuo
娥	rwu
梢	skio
坝	bjia
蚕	cheeu
敷	fueia
澜	leoi
杏	xkiaee
绥	sduo
冶	kcao
庇	bse
挠	noe
搂	looue
倏	sliu
婉	wwooa
聂	nga
噪	zsia
稼	jvo
鳍	qcei
菱	lieie
盏	vre
匿	nge
吱	vseia
寝	qjo
揽	loii
髓	sneu
秉	bgue
哺	bsei
矢	spo
啪	psei
帜	vbi
邵	sga
嗽	ssei
挟	xoeo
缸	gjeie
揉	roaoa
腻	nwee
驯	xfuii
缆	ldi
晌	smui
瘫	taa
贮	vzoo
觅	mhi
朦	mweiio
僻	pla
隋	sgeu
蔓	miiae
咋	zsue
嵌	qpei
虔	qroe
畔	pro
琐	sii
碟	dx
涩	seau
胧	lweu
嘟	dseie
蹦	baia
冢	vjeu
浏	leoe
裔	kjiau
襟	jjei
叨	dsa
旭	xmua
诀	jfae
虾	xhei
簿	byo
啤	psu
擒	qouoo
枣	zri
嘎	gseu
苑	yiua
牟	mcu
呕	rseu
骆	lfua
凸	tgi
熄	xuu
兀	wieu
喔	rsae
裳	sjio
凹	rgi
赎	sze
屯	tra
膛	twio
浇	jeeau
灼	vuua
裘	qjei
砰	pxe
棘	jria
橡	xkua
碱	jxe
聋	ldeii
姥	lwei
瑜	yiuo
毋	wb
娅	kwei
俏	qlio
沮	jeia
萌	miiaee
黯	rro
撇	poou
粟	sco
尹	kguu
粪	fzei
苟	giuai
癫	dae
蚂	mha
禹	yn
廖	lsa
俭	jluo
帖	tbi
煎	juo
窦	dpeiao
缕	ldou
簇	cyo
棱	lkei
叩	ksai
呐	nsi
瑶	kiuoo
墅	sjiae
莺	ktei
烫	tuo
蛙	whei
伶	lluo
歹	dqo
葱	ciuau
哮	xseieu
眩	xtoe
坤	kjiae
廓	ksoei
讳	hfee
啼	tso
乍	vneie
瓣	bbuu
矫	jpue
枉	wkee
跋	baeu
梗	gkeia
厕	cbi
琢	zieua
讥	jfua
釉	kno
窟	kpa
敛	luu
轼	sdee
庐	lsoae
胚	pweu
呻	ssiaee
绰	cdiei
扼	roeua
懿	kjoae
炯	jui
竿	gyee
慷	kooeu
虞	yri
锤	ckue
栓	skuoe
桨	jkoei
蚊	who
磅	bxo
孽	niu
惭	coea
戳	cka
禀	bti
鄂	rgia
馈	ksia
垣	yjei
咚	dsua
溅	jeiau
礁	jxu
钙	gkeie
彰	vzoe
眯	mtou
豁	hjeee
磷	lxou
雯	wxoe
墟	xjie
迂	yiee
瞻	vtua
颅	lhie
琉	lioea
悼	doiei
蝴	hhei
拣	joeaa
渺	meia
眷	jto
悯	mooi
汰	teeu
慑	soeiie
婶	swo
斐	ft
嘘	xsi
镶	xkoei
炕	kuoe
宦	hjei
趴	pau
绷	bdua
窘	jpae
襄	xti
珀	piui
嚣	xsia
拚	poao
酌	vcu
毓	yne
浊	veia
嗜	sseie
撼	hoeuei
扛	koei
峭	qpi
磕	kxei
翘	qqe
槽	ckeia
栅	skua
淌	tei
熏	xuue
瑛	kieii
颓	thu
忖	coei
颐	khei
牡	mkei
缀	vda
徊	hpia
梨	lkue
肪	fwoe
涕	teo
惫	buia
摹	moeiii
踱	daoe
肘	vwei
挚	voeie
熔	ruo
氯	liae
凛	lcoe
绎	kdao
庶	sseii
脯	pweia
睦	mteie
迭	diue
窍	qpeie
粥	vqo
庵	rseuo
沧	ceu
奕	knoe
怠	doa
沁	qeoa
咙	lseua
氨	rioo
矗	cai
盔	kreu
拇	moa
沛	peeia
榻	tkiae
揣	coiaie
崭	vpea
鞘	qiio
鞠	jiuaou
垦	kjae
唾	tsue
洽	qeuo
橱	ckeu
仕	sleie
蜘	vhue
痰	taou
袜	wje
峙	vpei
柬	jriao
蝉	chou
蟹	xhua
谏	jfeia
擎	qoeii
鹃	jtia
皓	hcu
朕	vwou
疤	baa
禺	ymi
铲	cko
酶	mcue
钝	dkeai
匣	xgia
氓	mtaa
弧	hqu
峨	rpue
锥	vkui
揪	joue
杠	gkeiee
吭	ksoeu
崛	jpaeu
诬	wfe
冉	rgie
抒	soao
庚	gsa
悍	hoia
靡	mrie
晦	hmu
醋	ccei
壕	hjoe
夭	kneu
锯	jkaeu
咦	kseaea
侈	clua
婢	bwui
猾	hfi
徘	ppi
硝	xxi
煽	suoa
皂	zce
嗦	sseio
舵	dco
狈	bfi
靴	xiuiu
捂	woei
疮	cauoa
郝	hia
苛	kieia
秽	hvia
茜	qiei
搓	cooue
芸	yieea
赁	lzu
酱	jcoe
檐	kkua
饷	xsuia
蕉	jiui
铀	kkiae
苔	tiao
赦	siueu
缎	ddu
舷	xcoe
筷	kyo
朔	swou
婪	lweiu
紊	wtaa
厮	sbei
婿	xwai
寥	ljaoe
兢	jaia
糙	czue
卦	guei
槐	hku
扒	bouoo
裴	pji
祀	svae
埔	pjei
絮	xdau
芭	biai
屉	twei
痪	haua
霄	xxio
绽	vdo
宵	xjio
邑	ksaie
霖	lxe
岔	cpuo
茄	jiaui
饵	rseii
韧	rqa
琪	qieii
邹	zgu
瑚	hieii
憋	boo
殆	dqa
噜	lsu
忒	toeo
忿	fou
衅	xro
淳	ceo
悖	boeio
髦	mju
孜	zhu
粤	yni
隘	rgo
濒	bei
铮	vkua
畸	jre
剔	tmia
坞	wjua
篱	lyo
淀	deoo
蓦	mfeii
唬	hsie
汀	teeii
趾	vaie
锣	lki
嫦	cwi
缉	jdiaee
斟	vde
鞍	riooa
扳	bouua
拴	souoe
诅	zf
谟	mfeiii
呃	rseua
懦	noeo
忏	couei
犁	lkuei
逞	ciia
拧	nooo
亥	hta
佟	tlua
叱	csua
舜	shoa
绊	bdou
龚	gde
腮	swia
邸	dgua
椒	jkie
蔚	wia
湛	veeiie
狩	sfo
眶	ktee
栈	vkeea
薇	wiuu
肮	rwo
瀑	pei
渣	veeiu
褂	gjeiee
叽	jsua
臀	twae
妞	nwai
巍	wpu
唔	wseia
疚	jaua
戎	rkee
鲤	lcia
肇	vvo
笃	dya
娴	xwoi
辙	vdoe
札	vka
阮	rgee
懊	rou
焘	duee
恤	xouia
疹	vau
潇	xeeii
铝	lkia
涤	deu
喽	lsou
恃	soeie
砌	qxe
楞	lkiai
遁	diuu
阱	jgee
咎	jsuao
洼	weei
炳	bue
噬	ssueo
拷	koeie
枫	fkuau
哆	dsuao
矶	jxua
苇	wieea
翩	pq
窒	vpeao
侬	nlo
胰	kweae
靶	biaie
芜	wieeu
嚎	hsoei
妾	qwau
辫	bba
幌	hbi
踉	lao
佃	dli
葫	hieiia
拽	voiaee
皖	wc
滤	leie
睬	ctuo
俞	yle
匕	bna
嗤	csiaie
谤	bfo
捍	hoiae
孵	fhuao
倪	nlu
瘾	kaa
匡	kgee
敝	buou
磋	cxou
绫	ldeieu
尧	kieau
淆	xeuoe
蕊	rioa
烘	huei
璋	vioeo
亢	ktua
轧	kdaa
赂	lzua
榆	ykuo
蝗	hhui
诛	vfuee
骏	jfao
勺	sdoo
梵	fke
炽	cuiae
笠	lyoe
颌	hhuo
闸	vgia
狒	ffa
樊	fne
垢	gju
瘟	wa
缪	mda
菇	gia
琦	qieu
剃	tmo
溺	neae
炫	xuoe
迸	bioue
惚	houau
嗨	hsoo
陨	ygia
赃	zzoe
羁	jyei
嘀	dso
臻	vra
膳	swoue
赣	gwia
殉	xqu
踌	cae
桔	jkei
瞿	qqi
闽	mgi
豚	tweu
掺	coao
沌	dee
喳	vseiu
惰	doeu
椭	tkai
咪	msou
霎	sxoe
侃	kli
猝	cfoe
戮	lkao
窖	jpuei
祠	cva
瞩	vta
菁	jieei
佬	lleie
躇	caei
咄	dsai
肋	lwa
忡	coiae
雍	ktaa
忱	cooa
蕾	lieoa
跄	qau
伎	jleiao
硅	gx
炊	cuua
钊	vkii
蝠	fhe
屎	swouei
拭	soee
谛	dfoe
褪	tja
丞	cra
卉	hae
隧	sgo
茸	riei
钳	qkeii
伢	klea
啃	ksie
舔	tjeeu
闺	ggeie
蹬	daa
挛	looei
眺	ttu
袱	fju
陇	lgeu
柿	skoei
殴	rdeu
梧	wkei
惺	xoia
侥	jlea
弛	cqa
琛	cioa
捅	toaoi
酝	yce
薯	siia
曳	kma
澈	ceoe
锈	xkuei
稠	cvua
眸	mtao
咆	psua
簧	hye
疡	kaau
鸥	rte
渎	deei
嬉	xwei
汲	jeua
脓	nwoau
穗	svei
骡	lfia
巳	saae
拎	louo
槛	kkiiu
邢	xgee
廿	nie
搀	coua
曙	smia
樵	qkui
隅	ygiae
筛	syiu
谒	kfiae
倭	wlue
痹	baiae
猖	cfia
佯	kloue
奚	xha
肛	gwei
抨	poeo
甭	bbeu
蛾	rhu
唠	lseii
嵩	spoe
荧	kueii
漱	seeia
攘	roo
诘	jfeie
酋	qpeia
篡	cyi
睿	rti
噩	rri
怅	couea
徙	xpi
盎	rria
鞅	kiiae
漓	leoeu
祟	svai
攸	kliu
睫	jtea
翎	lqu
呛	qsu
堑	qjea
檀	tkoe
筐	kyee
寅	kjeia
惘	woi
磊	lxeu
驭	yfa
吠	fseu
驮	tfeu
瑙	nia
炬	juea
痉	jaa
恺	koiai
曝	pmi
敕	cue
胺	rwoo
萤	kheii
筝	vyu
幡	fbuo
竺	vyee
霹	pxa
毗	pre
烙	luua
鸠	jtua
埠	bjuia
蒜	sieei
阜	faui
嘈	cseia
乒	pn
帷	wbu
啄	vseu
鳌	rc
毡	vvie
阙	qgou
褥	rje
搔	soaoo
笋	sya
冕	mmu
狞	nfo
韶	srau
骼	gnu
蔼	rioai
烹	pti
奄	knia
嫖	pweiai
沐	meeiu
噗	psi
岑	cpuoo
蛟	jho
咏	ksoa
弩	nq
掳	loie
圃	pgei
孚	fha
捻	nouo
悴	cooe
呱	gsuu
诣	kfua
祁	qva
捶	coueie
钠	nki
袄	rju
澎	peeie
恪	kouao
氮	diouu
雏	cqu
堰	kjeiae
彷	ppo
撮	coiaee
鹦	ktia
晖	hmo
犀	xwio
橄	gkaei
沽	geeii
腑	fwoeu
亵	xte
掐	qoua
龋	qfu
嗒	dseii
咀	jsi
祺	qvei
匾	bgo
锚	mkeii
乓	pni
萃	cioeu
贻	kza
揖	koiaee
觑	qei
吝	ltiae
憔	qoui
羌	qkaa
砾	lxua
蠕	rheo
诲	hfue
肴	kwuoe
撩	loeuo
坍	tju
酥	scuei
袅	nju
黝	kraa
俾	blui
嫣	kweie
穹	qpaea
秧	kvi
妊	rwue
溉	gea
聿	yv
鹊	qte
疙	gaue
蘑	mioeu
睾	gni
楷	kkea
茹	ria
酵	jcei
锌	xkoeo
滇	deeii
纂	zyi
辗	vdae
圭	gjeiee
幔	mbia
褒	btu
揍	zoee
倔	jlaeu
诽	ffi
腓	fwi
颉	xheie
锄	ckia
嗔	cseii
磺	hxe
攒	zoue
瘩	daei
雳	lxeua
吆	ksaao
悚	soeia
墩	djo
彝	kiaae
囱	cnia
逍	xii
辄	vdei
俨	klei
桅	wku
纶	lduo
悸	jouei
殃	kqia
帧	vbie
俐	llue
绮	qde
籽	zza
袒	tjiaee
孰	stiae
愫	soeei
拌	boou
暨	jvea
橙	ckao
敖	rueei
赘	vze
抉	joaeu
剌	lme
娼	cwia
淤	yeo
顼	xieu
哝	nso
葵	kiao
酣	hce
麓	lfei
琅	lioae
钵	bkeiuo
簸	byeii
禾	hvo
铢	vkue
璧	biae
娠	sweu
彗	hgee
惋	woooa
腋	kwoe
螂	lho
阪	bguu
劾	heoe
掣	couee
嚓	cso
沥	leeua
粱	lzoo
惮	doou
氖	niau
捎	soio
羔	gkooo
俟	qlao
渲	xeoo
榄	lkii
茧	jiia
霓	nx
胥	xai
鹉	wte
撬	qoue
橘	jkao
琶	piee
拈	noie
笆	bya
亟	jdii
痊	qauo
渭	weiae
狙	jfi
珂	kieiae
刨	pmu
蜕	tho
谚	kfoe
憧	cooeo
瞟	pte
拗	roaa
馒	msia
帚	vgoa
钗	ckaoo
哧	cseie
喋	dseiie
箫	xya
刁	dde
怦	poeou
缭	ldeu
湄	mea
迥	jiiai
渝	yeuoe
磐	pxu
冗	rjua
闵	mgoe
噶	gseii
黏	nv
蕃	fiuou
弼	bq
驿	kfao
淄	zea
饺	jso
踞	jaae
韬	tq
婷	twoe
唆	ssaou
蜒	khui
偎	wli
榨	vkooa
漉	leoeua
皈	gc
矜	jdoa
碉	dxu
笈	jyuao
枷	jkaui
鲨	scoo
蹑	nae
瀚	heeiia
癖	paae
谑	xfie
酪	lcua
揩	koea
炙	vuuao
烬	jua
蜷	qho
侏	vlue
凋	dcu
漪	keua
悻	xoeie
讪	sfiai
蹋	taiae
搐	cooea
碘	dxi
帛	bcia
诠	qfuo
碾	nxa
擂	loeo
苯	biei
诃	hfei
铎	dka
戊	wkeu
荀	xiua
攫	joiaee
驹	jfuai
憬	joiaee
哽	gseia
踵	vaue
蟒	mhe
漾	keouee
啧	zsee
吮	ssaoua
楠	nke
氟	fia
怂	souou
叼	dsae
偕	xlea
漩	xeoe
竣	jwa
翌	kqo
蹭	cao
挝	woeio
臆	kwoeo
崽	zpi
绚	xdua
糜	mzo
瘢	bauu
跤	jaoe
恬	toueii
阑	lgeiao
豢	hqo
汶	weo
跷	qae
琵	pne
憨	hoae
蜗	whi
螅	xhui
惴	voiai
戟	jkeii
匮	kgiae
恙	kko
抿	moae
桢	vkie
笺	jyee
瞳	tto
蛤	hhuoe
瓢	pde
潦	leeuo
秤	cve
芹	qiuu
跺	daua
哒	dseu
饬	csue
栩	xkaoe
曦	xmo
骷	kneii
丕	prui
卤	lre
嫡	dwoe
鬓	bjo
梓	zkoe
嗖	ssui
惦	dooe
浚	jeaou
咔	ksiee
荃	qiuo
藐	miuo
唧	jsae
玺	xiuai
汛	xea
铐	kkeie
髅	lno
渤	beei
皿	mree
箍	gyei
馅	xsuau
戍	skeuo
汾	feuoa
痔	vaei
褶	vjao
聆	lguoo
汞	goiau
涎	xeui
奂	hmia
巅	dpeii
渍	zee
疣	kaeua
傩	nla
逵	kieie
耆	qmei
蟋	xhuou
鳄	rci
讹	rfu
膺	ksuiu
蹿	caoo
沂	keuu
筏	fyui
釜	flee
坯	pjeu
峦	lpo
摒	boae
茬	cieu
蟀	shoe
撵	noee
浒	heoau
缤	bdoo
嵋	mpa
珑	lieu
苞	biua
瑾	jiei
暧	rmuo
泵	bxi
钾	jkia
赓	gsae
叟	shuie
佚	klue
沓	deia
撂	loia
晏	kmoo
璐	liiae
甥	skei
蛊	ghi
漳	veoe
瘪	baui
阉	kgeu
蹂	raa
琏	lieae
鳃	sci
湃	peue
辘	ldoe
僭	jleau
躏	lae
鼾	hiee
懵	moeiii
寐	mja
褚	cjeieu
镰	lkoe
攥	zoueo
涧	jeoi
蝙	bho
脐	qwoe
辕	yde
杞	qkae
涣	heua
煜	yui
骥	jfie
傣	dlee
嗳	rsuo
祯	vviei
酉	kce
捺	noeu
瑕	xiaei
秸	jveie
鑫	xkuo
馋	csuai
窿	lpa
楔	xkee
胱	gwio
荔	liau
蟆	mhei
屹	kpuea
湍	teia
轲	kde
遐	xiaeie
镯	vkiai
缰	jdei
桦	hkui
炖	duea
啬	saoue
羚	lkuoo
诩	xfao
钡	bki
绯	fdi
掖	kooeui
箓	lya
涸	heiae
塾	sjoe
鸳	ytu
呸	pseui
抡	louou
擞	soou
熹	xueie
坷	kjeiae
亘	gria
嗟	jsou
瓮	wwuo
筵	kyu
跛	baau
汕	seiai
欤	yke
壑	hjie
颍	khua
姗	swua
溥	peeiae
踊	kaao
暄	xmoo
枭	xkuao
稷	jvia
跚	saua
涟	leea
瀛	keoea
笙	syue
滕	twoue
踝	haia
瞰	ktae
贰	rz
恻	coiau
嚏	tsei
獗	jfeu
迢	tiau
睑	jtuo
邯	hgei
珥	rieii
萦	kdei
赡	szu
酮	tci
璞	pii
羹	gkoooo
缄	jdeu
俸	fleee
媲	pwui
晾	lmo
鸾	lto
恿	koaoi
蜿	whoo
扈	haiae
犊	dkeia
蜈	whia
讷	nfi
戌	xkeue
翟	dqui
蓓	biui
藕	riee
谀	yfui
谩	mfia
卯	mgua
岐	qpeiao
谙	rfo
荼	tiuoe
蝎	xhi
椰	kkeiie
甄	vweia
蟾	chu
蹊	qauoo
镀	dko
撸	loua
泞	neoo
螃	pho
檬	mkeiio
猓	gfi
羲	xkueiu
蔷	qieio
瘸	qaa
蘸	viei
蔗	vioeu
傀	glu
蚌	bhe
锢	gkiaei
恚	hoeie
遽	jiie
邃	siooa
皑	rcia
簌	syei
锵	qkoe
昊	hmee
焙	buoe
鹳	gte
睽	ktao
刽	gmu
呗	bsi
噎	kseie
寰	hjia
鳖	bco
唷	ksoea
殡	bqo
恣	zooe
淖	neie
睐	lte
诰	gfue
婵	cwou
榈	lkoi
氦	hioe
蛹	khao
靳	jiuu
惬	qoee
蹙	caeu
鸯	ktiae
眈	dto
罡	gyeie
诙	hfeu
缮	sdou
胤	knaao
皋	gce
蛀	vhoe
偌	rlei
疵	caie
绛	jduao
葆	biuii
喙	hsaa
黔	qru
佼	jloe
儡	llia
斓	ltoi
烽	fuu
嫔	pwoo
颚	rhia
龈	kfae
娓	wwa
盅	vria
坂	bjuu
町	tre
瘠	jaoeu
芥	jiuo
啜	csa
挎	koeuoe
橇	qkueea
荟	hiuo
阂	hgo
垛	djua
淇	qeeii
瓒	ziu
篓	lyou
虱	shau
跻	jaoeuo
蹒	pae
髯	rji
龛	kleia
痫	xao
瞠	cti
掂	dooeu
潼	teoe
酰	xcu
镁	mkou
灸	juu
筱	xyui
腆	twia
谆	vfoe
壬	rjue
椋	lkoei
茗	miua
骋	cfiae
蛔	hhi
潺	ceae
扉	fai
耘	yye
槟	bkoo
甬	kba
雹	bxua
淞	seeiu
谥	sfou
燎	lueu
蕙	hieia
蚪	dhoo
蜻	qhee
轶	kdue
郸	dgou
楣	mka
狰	vfua
捋	louoo
涓	jeiae
荪	siaiei
娄	lza
麝	sfuia
薰	xiue
蚤	zha
醮	jcui
搪	tooe
湮	keeia
瞌	kteie
谧	mfoa
辍	cda
梆	bkeee
樟	vkoeo
茉	miee
岖	qpeuo
癣	xau
穑	sveio
臼	jcee
玷	diie
馍	mse
呷	gsi
妩	wwee
萼	riiae
伫	vlo
彤	tzua
媛	ywu
岬	jpia
莓	miue
惆	couae
鳎	tcia
啾	jsue
囔	nsei
蜓	thue
孺	rheoa
徇	xpua
徵	vpi
岱	dpui
昵	nma
焊	hui
卅	srui
邙	mgoea
飙	bjeu
痞	paeu
隼	sqe
恫	doia
怆	couoa
桀	jkuao
绶	sduoo
裆	djio
桧	gkuo
盂	yre
蚓	khae
嗷	rsee
抠	koeuoa
槌	ckui
痘	daeia
痢	laue
芮	riiau
蚣	ghuo
铿	kkiia
闩	sgee
飓	jjiaee
疱	paua
蝌	khue
撅	joeu
蚯	qhui
斡	wai
窠	kpi
荚	jieo
耷	dnei
牒	ddei
砚	kxi
煦	xui
赈	vzeu
嗫	nseii
耙	byai
榕	rkoo
鞑	dieu
袤	mtaoa
谌	cfei
醺	xcue
秆	gve
徨	hpui
橹	lkuai
翡	fqi
缨	kdi
锹	qkuei
嵇	jveua
圪	gjue
髻	jjeie
嗬	hseiiu
痣	vaeie
辎	zda
娩	mwu
蛐	qhi
谄	cfu
鹞	ktuo
翱	rqu
庖	psuaa
籁	lyei
蓿	xioo
鳗	mci
疟	naea
鲇	nci
嚅	rseo
瘀	yao
颔	hhuoo
黜	crai
黠	xre
濑	leeia
忐	toie
洵	xeua
馁	nsu
忑	toei
砥	dxua
咂	zsei
罹	lyoo
糠	kzoe
偃	kleiae
匝	zgi
淙	ceoo
喏	nseiie
祛	qveie
纫	rda
闾	lgia
腼	mweu
蛰	vhei
曜	kmao
涝	leeii
厩	jba
洄	heiai
煊	xuoo
疽	jaiae
闰	rgeei
汐	xeuao
璜	hieiie
藓	xiuaia
铬	gkuao
渥	wea
靼	diiae
噤	jse
苓	liuo
酗	xcuo
咫	vwoi
椿	ckee
鲫	jca
罔	wgo
锭	dkoo
锺	vkuei
匍	pdei
祗	vvua
锰	mkai
岌	jpua
畹	wro
馀	ysuo
熠	kua
糯	nz
胫	jwao
銮	lkoeii
旌	jkue
棣	dkae
沅	yee
孢	bhua
豌	wjo
熵	suoeo
盹	dtea
腌	kweu
镭	lkeo
驸	ffui
镐	hkoei
馐	xsou
嘤	ksiau
癞	laei
骰	tnu
瞑	mtoa
裨	bjuiae
阖	hgeie
韭	jrie
宕	djeu
戾	laeu
镌	jkuio
溟	meoa
牍	ddeia
隽	jqa
婊	bwee
鹄	htu
埂	gjeia
拄	vooee
娲	wwi
虬	qhaa
萱	xiooa
啵	bsoo
蠡	lha
芋	yieei
胭	kwiae
豺	cgei
啻	csoe
褛	ljou
蛆	qhia
掰	bouoau
柠	nko
篆	vyaa
倌	glo
咛	nsoo
蛭	vhea
澹	deua
纭	ydee
荨	qiae
莞	gio
谡	sfiae
潞	leia
郅	vgea
弋	krao
螳	thi
飕	sjuie
胄	vwiae
蟑	vhoeo
宓	mjo
昙	tme
猥	wfia
蟠	phu
锏	jkoi
匐	fdeiae
柑	gkeii
濮	peuii
烯	xuuo
蟮	shou
仄	zb
偈	jlia
箴	vyeu
粼	lzuao
蜃	sni
嗥	hsuia
褴	ljii
蕨	jieu
圩	wjee
蓟	jiuai
孪	lhoe
杳	kkiaee
魇	kbeuo
簪	zyea
荤	hde
诿	wfu
氲	yiia
摞	loiae
镂	lkoue
飒	swuau
夙	sreu
舀	khuie
臧	zkeu
蒿	hioei
貂	dga
蜥	xheiu
蹩	bao
噼	psa
钛	tke
钚	bkeui
濂	leoeuo
獾	hfeii
皙	xce
铠	kkiai
霭	rxo
鲈	lcie
叵	pgia
霾	mxuo
泯	meae
碴	cxe
鸵	ttoo
峪	ypuo
饕	tsi
瘁	caoe
睢	stui
纣	vdeio
迩	riua
鬃	zjoo
夔	kpeui
垠	kjaee
榭	xkui
饨	tsea
娑	swoo
篝	gyeei
隍	hgu
榔	lkoa
洌	leeuao
浜	beu
鲑	gcei
汩	gei
浣	heoo
舐	sjua
谔	rfia
忻	xouue
咻	xsuie
唑	zsuo
鹑	cto
懋	moeiu
皎	jcoeu
诒	kfaoi
麾	hvoe
辏	cdee
冽	lceu
氐	dna
箕	jyeii
俚	lliae
宸	cjeue
汴	beoe
捱	roeue
芍	siuao
摈	booo
摺	voao
簦	dyao
咝	ssaa
箔	byoo
孀	sweo
怏	koiaeu
谝	pfoa
漕	ceei
砧	vxi
罂	kjiauo
耄	mjuu
馕	nseia
栾	lkoeii
榘	jkuee
沣	fee
烷	wuo
俑	klao
榷	qkoa
沱	teoo
缜	vdeii
鹫	jtoe
蛳	shiu
剽	pme
泗	seiau
衢	qpia
臊	swiae
瘴	vao
晁	cmu
纾	sdao
酚	fcuo
孛	baoa
炀	kuau
叁	sce
憩	qouei
掬	jouao
椤	lkiaii
啮	nsie
畿	jdao
掸	dooui
镣	lkeu
骁	xfeau
侗	dlia
椽	ckaa
泓	heae
滦	leoei
癜	daae
荩	jiae
蚱	vhuei
酯	vcua
庑	wsee
扪	mooia
歆	xru
癸	gjee
蚜	khea
蝮	fhue
蹶	jaeu
弈	kioe
庋	gseiao
喟	ksiae
滂	peo
啕	tsua
蛎	lheu
槁	gkoe
獭	tfeia
翊	kwa
龊	cfiaei
燮	xho
莘	sioe
邺	keai
剁	dmua
觐	jeeii
铛	dkio
臃	kwoea
谗	cfua
镍	nku
墒	sjoeo
晔	kmui
燔	fuuo
嘭	pseie
涿	veeu
醯	xcoea
箩	lyia
睨	ntu
鄱	pguo
坳	rjaa
砷	sxia
诤	vfuaa
鹭	ltiaei
唏	xsuo
伲	nlae
殁	mqua
猬	wfiae
琥	hii
蚩	cha
泾	jeaoe
缥	pdeia
殓	lquo
鳅	qcu
刍	cma
嶙	lpou
氰	qieei
舫	fco
芷	vii
诋	dfua
逅	hiuu
呓	kseiia
唰	ssae
妫	gwo
茁	viai
馑	jsei
骧	xfoe
峋	xpuai
擢	voaoe
苷	giei
袂	mjae
懑	mooo
蓑	sioei
涞	leeo
祉	vvieie
踹	caia
噫	ksoeo
掇	doao
沏	qeea
诳	kfuau
饽	bseio
绺	lduao
饪	rsuei
谘	zfo
迳	jiaoe
飧	swuo
铡	vkiau
枞	ckuo
熨	yua
荭	hiaa
鋈	wko
俦	clee
戛	jkeu
赊	szuo
幺	kcaa
湎	meeu
凇	scei
芪	qiua
觯	vxo
龌	wfa
嘁	qseu
嬴	kwoeai
挞	toeuo
苻	fiui
鞯	jieii
肽	tweuo
恸	toee
迨	diao
钰	ykee
儆	jleii
觎	yeuoei
讫	qfue
僮	tloe
媾	gweei
滓	zeoo
龇	zfi
斛	hxo
杈	ckaooo
涮	seae
疸	daia
绾	wdoo
胯	kweuo
觥	gxi
赳	juai
卞	btio
愠	yoia
庠	xsoue
拮	joei
烨	kuui
窈	kpaa
菠	biooe
罄	qjeie
咣	gsio
囤	dgea
奘	zna
弁	bce
缫	sdaa
腴	ywui
缈	mdi
喵	msei
柚	kkiaei
潢	heeiie
遛	liua
琨	kiiaee
荻	diua
藜	liuei
郏	jgeo
镳	bkoeu
雉	vpui
橐	tkei
艮	gvo
蛉	lhu
骈	pfoue
寮	ljeu
搽	coeii
柩	jkeua
濡	ree
佗	tloo
啷	lsoaee
诜	sfue
偻	llo
夯	hna
闱	wgeea
夥	hwi
枸	gkuai
筠	yyei
膑	bwoo
虻	mhoea
谖	xfuo
埽	sjaee
笞	cya
臾	ycuo
婀	rwa
珞	liuao
粑	bza
崂	lpei
怵	coeiu
殒	yqi
绻	qdo
觊	jeiai
嗑	kseiea
昱	ymoe
榛	vkeee
颧	qhei
蜴	khiaee
鳝	scou
噙	qsuo
淼	meiau
囿	kgeui
矾	fx
硼	pxua
泅	qeia
蠹	dheia
邂	xiuau
钜	jkea
垩	rjei
乩	jdie
嗝	gseiae
淦	geuo
樽	zkou
诮	qfio
啐	csoeu
揆	koaou
榉	jkoo
淅	xeeiu
暹	xiia
辔	psaa
馗	knao
骛	wfao
鱿	kceu
犷	gfo
獠	lfeu
竦	swei
苫	siie
詈	lyoee
篙	gyo
诨	hfoa
峒	dpiaei
滢	keeii
蜚	fhi
铰	jkoeu
馄	hsiae
琬	wioo
靓	jciau
犟	jkaea
狻	sfaou
璨	ciie
螨	mheii
鸬	ltie
嘹	lseuo
芩	qiuoo
蜇	vheie
锟	kkiaee
栉	vkeiia
洹	heeia
俪	lleia
钍	tkeie
瑁	miiaee
锨	xkuue
壹	kjoaei
痿	wau
犄	jkeuo
瘙	saao
粕	pzu
抟	toeea
衲	nji
饯	jsee
踮	daoeu
龅	bfu
愎	boue
馥	fvi
梏	gkue
艿	niauu
讣	ffio
趺	fae
邝	ksaii
鲟	xcae
剜	wmo
笥	syae
绉	vduaa
罅	xjiea
衩	cjao
姣	jwoeuo
斫	vxu
鹗	rtia
晗	hmuo
爻	knou
猕	mfae
窕	tpu
铩	skuoei
仨	sleee
崴	wpe
搡	soaoa
酢	ccue
佞	nlee
檄	xkuia
璀	ciiai
岷	mpae
舛	cwea
邕	khiaea
铂	bkuia
霁	jxo
犒	kkoe
阈	ygei
馏	lsua
麋	mfou
麒	qfei
妍	kwee
宥	kjeui
摁	roiae
涔	ceia
苁	ciuou
铤	dkue
锷	rki
嗲	dsuo
恽	yooa
麂	jfuaa
胛	jwiaee
赝	kbui
哂	sseia
呶	nsau
噘	jseu
懔	looeia
撷	xoeiei
栎	lkuaiu
桎	vkea
霰	sxeii
飨	xsaa
噔	dsao
娣	dwou
揄	youoei
咤	vso
忝	toeeu
薏	kioeo
嗵	tsaoi
泸	leiea
胪	lwi
贲	bze
迤	kiue
鍪	mkao
僖	xlei
刈	kmuo
咿	ksuia
蔫	niei
鹌	rteu
嗪	qsee
岫	xpia
嵘	rpei
怼	doaoe
茏	lieua
茯	fiuie
轱	gdei
铨	qkuo
昕	xmuu
咩	msoue
澧	leiae
郢	kgiaee
馊	ssuie
髡	kjeua
濯	veao
盥	gru
苣	jiea
囡	ngau
砺	lxeue
佘	sleeiu
弑	snoe
楂	vkeiu
翦	jqou
谶	cfuo
怩	noaeu
楹	kkaua
蠼	qhiae
霏	fxi
讴	rfe
锲	qkee
慵	kooeua
砭	bxuo
胝	vwuae
杵	ckuee
樾	ykei
潍	weaa
帼	gbi
碣	jxia
啶	dsoo
徕	lpeo
胴	dwiae
裟	sjoo
诌	vfuaae
钴	gkeiia
楫	jkiae
赭	vieie
铣	xkueie
铱	kkoeu
碛	qxee
酊	dcei
醛	qceii
魑	cgoe
剐	gmiae
畦	qre
闶	kgoe
阄	jgua
陂	bga
祚	zvu
鹘	gnua
泱	keiaeu
趄	juia
陲	cgu
骅	hfui
倜	tluae
呤	lsuo
燧	suou
郧	ygiaei
铉	xkoea
粲	czie
骶	dnua
峁	mpu
忸	noaie
戡	kkeiie
渌	leae
骞	qfooa
髭	zji
苋	xiiau
蜊	lhue
谲	jfaoa
钨	wkua
锃	zkia
幄	wba
戕	qye
虢	ghei
闼	tgeu
骊	lfeia
傥	tlio
妲	dwiaee
桠	kkeiio
烩	huuo
绌	cdai
袈	jja
揿	qouee
杲	gme
肓	hwo
薮	sioue
厝	cbei
氤	kiiaeu
缙	jdeii
莅	liui
旖	kkue
硒	xxe
衮	gtuo
诟	gfuu
唁	ksoee
嬗	swoe
硎	xxee
裱	bjee
颦	pai
煨	wui
礴	bxei
纥	hdue
鏖	rfuo
靥	kbeuoo
笏	hyu
羿	kqeu
蝈	ghia
湟	heuia
炜	wuee
煲	buu
甑	zwou
笕	jyi
锉	ckuou
鼐	ndui
喑	ksoeou
妪	ywe
嶂	vpo
弭	mqe
浔	xeae
锂	lkiae
孳	zho
苡	kiaou
醴	lciae
颏	khoea
渚	veeie
蚝	hhue
轭	rdeua
鹬	yta
痨	laeii
耦	ryi
膘	bweia
褡	djeii
覃	tciae
邛	qoa
篾	myi
馔	vsae
兖	ktuoa
爰	yhe
痂	jaau
耨	ny
艄	scio
遨	rieei
阋	xgui
昶	cmo
沤	reeu
焓	huuoo
秣	mve
邋	liaa
俎	zlu
绦	tdu
榫	skui
蟪	hheia
氩	kieiio
烃	tua
稗	bv
謇	jfoo
锴	kkeau
龉	yfei
俣	yli
嬷	mwoe
痤	cauou
笫	zyu
肱	gweu
鸢	yte
砣	txo
碜	cxa
芨	jiuaoo
莆	piei
菏	hioo
阕	qgao
鼹	kpia
猷	kfou
竽	yyee
舸	gceia
诓	kfee
錾	zkea
姘	pwouee
婕	jwea
悌	toou
槭	qkeui
淬	ceoeu
邈	miuoo
隗	kgui
歙	skuoei
稹	vve
蹴	caoei
痈	kauae
砒	pxea
羯	jkiaee
豕	sqo
镏	lkuaoa
鲂	fcoe
匦	ggea
笤	tya
蓖	biuia
峥	vpua
徭	kpuo
浃	jeeo
烊	kuou
缢	kdou
翳	kqeue
蚨	fhee
褓	bjuii
趔	lueua
酆	fge
仃	dlei
勖	xeia
泷	leeuau
炔	guae
葺	qiia
蚴	khaa
蛴	qhoe
誊	tfou
赜	zgii
媸	cwai
俳	plie
孱	cwaie
砦	vxie
祜	hve
茑	niua
诖	gfe
跸	baea
逡	qiao
伉	kloe
屐	jwuu
溴	xeuia
蛞	khuei
飚	bjou
圻	qjuu
崆	kpoo
庾	ysui
掮	qooa
橛	jkeuou
矸	gxe
缂	kdeii
蒯	kmei
鸨	btua
啭	vsea
蛩	qheie
蠖	hheii
诹	zfe
镉	gkeiae
饧	tsau
鸪	gtei
劭	seaui
哐	ksee
崧	spei
杼	vkao
棂	lkae
螫	shei
遑	hiuia
颢	hhia
饔	ksoeaa
龃	jfia
腱	jwae
襁	qjaea
忾	koue
濠	heoei
牝	pkua
蛄	gheii
鲆	pceo
嗄	rseui
灏	heiaee
嘣	bsia
夤	kwoo
疥	jauo
砝	fxe
苜	miiaee
荞	qiueu
颞	nhe
忤	woue
旎	nkue
瘛	caee
辇	nde
遢	tii
魉	lgeiau
娌	lwia
毂	gdeie
氚	ciui
涫	geoo
瓤	rdo
碇	dxo
臁	lwoe
荥	xeeiio
吡	bsea
壅	kjoea
毖	bno
玮	wieeai
缛	rdeue
羟	qkao
珈	jiauia
虼	ghue
颀	qheu
佝	glua
珏	jieeie
翕	xquo
遴	liou
郛	fguo
氅	cvi
玖	jiuaoo
粽	zzoo
诂	gfei
蹇	jaoo
逋	bieia
岢	kpeia
聒	ggue
髁	kniae
淝	feua
潆	keeiio
芾	fiei
闳	hgeu
鞣	riao
髋	knoo
鲎	hjoa
黍	svu
汨	meiae
胍	gwuu
戬	jkeiio
钤	qkuoo
铵	rkooa
阏	rgoe
鬈	qjou
鹜	wtao
崮	gpia
枰	pke
樯	qkeio
畲	sleeiu
脍	kwuoee
衾	qjuo
蹼	paii
劬	qeua
咭	jseie
囫	hgua
洱	reei
刎	wmu
琊	kieai
碚	bxoe
芏	dieie
鳕	xceo
嘧	msoo
恂	xouai
槿	jkeiie
绀	gdeii
芎	qiaea
谪	vfoeo
鲢	lcea
鲧	gcu
噱	jsie
浠	xeuoeu
潸	seeiuo
跏	jaaui
郦	lgeiao
鲶	ncuo
抻	coiaee
琰	kiouu
矍	jhiae
臬	nnei
苌	ciue
鹚	ctou
龆	tfa
呔	dseuo
芄	wiua
觞	sxu
雒	lqua
槎	ckou
舂	cceee
钒	fkuao
阒	qgi
饫	ysue
鸩	vto
妗	jwuo
稔	rv
穰	rvo
莒	jiiae
萸	yiui
蚧	jhuo
谠	dfio
阡	qgue
餍	kbeuoo
芗	xiaau
菸	kioea
葩	piuia
谯	qfui
踔	caiei
佻	tluo
倨	jlaeue
厣	kbeuoo
嘌	pseia
蠓	mheiio
钏	ckuii
饩	xsue
黩	drei
恁	noui
殚	dqou
缬	xdeiei
藿	hieo
鎏	lkooe
钿	tkiaei
呋	fsee
囟	xni
婺	wwao
旃	vkueu
瓯	rwe
绱	sdio
鄣	vgoeo
酩	mcua
锶	skia
恹	koeue
缦	mdia
逶	wiue
鸹	gjua
媪	rwi
殇	sque
濉	seiae
篑	kyi
菟	tiuai
螟	mhoa
讦	jfeei
邬	wgua
醪	lca
阗	tgei
鲛	jcoeuo
嫠	lwee
峤	jpueu
肼	jweeu
芡	qiuau
鄯	sgou
岘	xpiau
愆	qouu
掼	goaai
焖	muo
矽	xxu
聩	kgiaei
讧	hfeie
卟	bsio
姒	swao
挈	qoeee
杷	pka
砉	hxee
笳	jya
菖	ciiae
蚋	rhiau
袢	pjo
靛	dcoo
踽	jaui
黾	msiae
侩	kluo
凫	frua
挲	sooo
笪	dyia
莜	kiuii
诔	lfee
郯	tgou
韪	wqia
鼋	yreu
嵊	spue
箸	vyeie
菅	jioo
裢	ljea
趿	tauao
圜	hgi
旯	lmu
涪	feo
莠	kiuei
莴	wii
赍	jzei
阌	wguo
嗍	ssou
囵	lguou
巽	xpa
曷	hmua
柞	vkueie
榧	fkei
笾	byau
簟	dyei
裰	djao
跎	taoo
枋	fko
绔	kdeu
讵	jfea
逖	tiuauo
镒	kkou
餮	tseu
骓	vfui
魃	bgeu
乜	mdaa
瑭	tio
踅	xaei
鄢	kgei
荛	riea
蟛	phe
馓	sseiie
鳟	zco
姹	cwoo
忪	souoa
桉	rkooaa
氘	diuii
氪	kieiia
纰	pdea
阍	hguae
傈	lleiai
垅	ljeua
娉	pwi
旮	gmua
汊	ceaoo
纡	ydeei
缟	gdoe
镢	jkeuou
堋	pjua
庥	xsuiei
枥	lkeua
槊	skoue
笮	zyue
缁	zdaa
腭	rwia
蔺	lioi
跞	laua
髂	qnoo
魍	wgi
鹕	hte
吒	vsue
搿	gouo
枳	vkiae
禳	rvoe
舻	lciea
蜍	chuo
醚	mco
鏊	rkeei
鹧	vtoe
珩	hiuui
蒺	jioeu
蜢	mhai
钹	bkeua
鬻	yqo
卮	vnue
垭	kjeii
瘘	laou
苄	bioei
苕	siau
菀	wiooa
袷	jjuo
跹	xaue
骠	bfe
磬	qxei
笸	pye
缶	fji
鸷	vtei
牦	mkuee
琮	cioo
砩	fxa
纨	wdua
芰	jieia
蕲	qiou
蠲	jpeu
郓	ygoa
锒	lkoae
锕	rkai
阆	lgoae
妯	vwiaei
舢	scia
趸	daea
驷	sfiau
鹩	lteu
嗉	ssee
笊	vyuu
芫	kiee
蠊	lhoeu
枇	pkea
浯	weeia
焱	kuouu
莸	kiuau
阃	kgiaei
饴	ksao
擤	xouiae
柢	dkua
醢	hceu
铆	mkuau
呲	csiei
堀	kjaeu
崾	kpeiai
帙	vbue
溆	xeuoee
潴	veu
牖	kdoa
硪	wxu
碓	dxui
鬣	ljaa
鹆	ytuo
僳	sleia
幂	mjia
桁	hkuu
獐	vfoeou
疝	sai
箝	qyei
蛱	jheo
诎	qfa
郴	cgeiu
鳏	gci
呦	ksaaoa
嗌	rsou
囹	lguooa
揶	koeii
脲	nwaeui
茴	hiia
螈	yheu
痼	gaiae
胨	dwea
膈	gweia
贽	vzei
赅	gzoe
锑	tkou
镊	nkei
鳊	bcoa
峄	kpao
桡	rkea
苤	pieu
雎	jqi
鞫	jiuaoe
鲋	fcui
鼬	kpiae
昀	ymu
熘	luuao
獯	xfue
疖	jaai
痍	kaea
蟊	mhao
鞴	bieii
乇	tnea
侪	cloe
嵴	jpo
栀	vkuu
槲	hkua
炝	quuo
炷	vuo
硐	dxia
羸	lkoea
裾	jjae
锸	ckuei
鹂	ltei
佰	bleu
僦	jloei
哔	bseau
屙	rwai
掾	yoa
旆	pkue
牯	gkeiia
珐	fieie
钪	kkoeua
仟	qlue
圮	pjae
崃	lpeou
廪	lsoe
擘	boaeu
笱	gyu
芟	siuaa
跗	fauie
鲅	bceu
匏	pnee
嗾	ssoe
圄	ygeia
彀	gdeieo
硷	jxuo
苎	vioo
勐	meai
卣	kuia
愍	moaea
掴	goiae
浞	veiae
涑	seeiae
玳	diuie
畛	vruo
粳	jzeia
赧	niai
刖	ywii
擀	goeiia
椴	dkuie
湫	jeue
箧	qyee
貉	hguao
逦	lieia
铄	skuai
鲮	lceie
啖	dsou
悭	qoii
愀	qoueiu
朐	qwu
畈	fruu
茱	viuee
蛘	khoue
訇	hdo
鹨	ltao
佶	jleie
凼	dgi
晟	cmeua
缃	xdeiu
苴	jiiaee
颛	vhi
鲱	fci
佤	wlea
厍	sbea
徉	kpou
氡	diuao
洙	veue
癯	qaiae
胗	vwuo
锆	gkuei
鞒	qiueuo
勰	xeau
繇	kduo
螭	choeu
钺	ykea
嵬	wpui
瘿	kaia
肟	wweea
肫	vwea
轸	vduo
仞	rlau
奁	lne
宄	gjuaa
樗	ckeo
熳	mui
睇	dtou
蝼	lhou
跆	taao
轳	ldie
钼	mki
鲰	zcei
榇	ckoe
薜	biaeu
裥	jjoi
诶	rfa
铧	hkuiu
寤	wja
帑	tba
怄	roeuo
矬	cpuou
硗	qxea
碡	dxe
糅	rza
缗	mdae
虺	hheu
镧	lkoia
雠	cqoa
鸱	ctua
啁	vsua
埙	xjiaei
悒	koiaea
犍	jkaee
硌	gxu
艉	wca
虿	chea
蛑	mhaou
锩	jkou
咴	hseuo
筮	syeiu
糁	sza
肄	kvua
艏	scoue
鼍	tsia
劢	meea
砻	ldeui
籴	dzu
蜮	yhei
骜	rfee
黢	qrao
龀	cfuaa
畚	bceuo
稞	kvia
耪	pyo
觳	hdei
鬯	cguo
鲲	kcia
鹁	btei
娆	rwea
捌	boia
柘	vkeui
獬	xfuau
篪	cyuu
菔	fiuae
伥	clue
孬	nru
滟	keee
狎	xfia
磔	vxua
綦	qhaao
聃	dgia
谇	sfoe
谰	lfoi
遒	qioue
鄄	jgei
闫	kgeee
鲡	lceia
齑	jtie
泠	leuoo
砗	cxea
蔻	kioo
钕	nkau
镫	dkao
佥	qleo
嶝	dpao
煅	duui
煸	buoa
罘	fyeui
胂	swiaee
菹	jiooe
螯	rhee
躅	vaia
鲠	gceiae
哞	msa
坨	tjoo
徜	cpio
慊	qoou
洳	reau
渑	meiaei
灞	beeo
盍	hre
縻	mdoe
羰	tkiai
菽	siiee
萘	nieu
褫	cjuu
踯	vaou
钋	pkio
鸫	dteai
俅	qlei
怛	doiae
洮	teuoe
罴	pyei
胼	pwouee
芤	kiaie
镛	kkoeua
隳	hoai
啉	lseiu
噌	csou
嫱	qweio
焐	wuei
绲	gdiae
膻	swoei
芊	qiuei
亓	qyu
倮	lliaee
嘞	lseiie
缒	vdui
莼	ciaa
蘅	hiuuiu
镆	mkeiii
伧	cluo
唳	lsoaeu
檩	lkoeia
澍	seeie
荏	riui
蘖	niui
蚬	xhia
韫	yqia
骱	jnuo
鸶	sta
嘏	gaiaea
垡	fjui
怙	hoeiia
焯	cuie
羧	skaouo
腚	dwoo
鼙	pjia
亳	btia
倥	kloo
昴	mmua
枵	xkiaee
粜	tza
舨	bcuu
艽	jiuaa
荠	jioeuo
醣	tco
魈	xgio
杓	bkua
楦	xkoo
楸	qkueiu
珲	hioa
甙	dreii
疃	tro
茔	kjeiio
蛏	chao
蠛	mheiii
髌	bnoo
嬖	bwae
笄	jyeeu
蜣	qhou
诼	vfeu
跣	xauei
钣	bkuu
喾	kjoau
戆	vooeo
蜉	fhuo
铍	pkau
岵	hpei
瓴	lwuo
肷	qwua
薹	tie
陉	xga
怫	foae
窀	vpeai
缯	zdou
荽	siuo
钭	dkooe
倬	vlie
帔	pbau
摭	vooeu
楝	lkeia
痱	faie
蚶	hheiie
螬	cheia
髑	dni
殛	jqai
狷	jfiae
粝	lzeu
萋	qiea
葭	jiaei
衽	rjuei
裉	kjaeea
鳢	lciaei
鼗	tnoe
傧	bloo
喁	ksiaee
嫘	lwiae
愦	koiaei
罟	gyeii
蝽	cheee
裼	tjiaee
钌	lkai
哌	psuu
墉	kjoeua
廛	csiae
粢	zzoeu
衿	jjuoo
跫	qaei
醵	jcie
鐾	bka
锗	vkeie
堇	jieiae
婧	jweeie
扦	qoueii
暌	kmaou
罱	lyeii
脘	wwooae
蹰	caeue
镞	zkoea
陟	vgie
鳔	bcei
侔	mla
唿	hsuau
岿	kpiu
疴	rae
砹	rxe
薨	hiiai
郾	kgeia
麸	fgee
偾	fleie
呒	msee
拊	foui
撺	coooa
椁	gkoei
榱	ckoei
滁	ceai
狯	kfuoe
猢	hfeiia
璎	kiiau
眦	zti
罾	zyo
裎	cji
铳	ckoea
崞	gpo
缇	tdi
蝣	khoeau
冼	xcuei
晷	gmuao
狲	sfai
痧	saoo
缱	qdi
萑	hiuio
儋	dluae
帏	wbe
憷	coeiuo
狍	pfu
疠	laea
窨	xpoe
绨	tdo
蕖	qioo
袼	gjuao
锛	bkeuo
嵝	lpoue
庀	psuaaa
汜	seaea
泶	xjoa
炅	jmouu
煳	hueii
瓠	hdeu
窳	ypuu
蘩	fiue
虮	jhua
蚰	khiaei
邰	tga
捩	looa
砀	dxa
苊	rieu
莪	riue
螽	vhua
蹉	caou
曛	xmue
槔	gkui
犸	mfaa
蘼	mioeue
蛲	nhea
衄	nra
隹	vqee
鹾	crou
墀	cjae
泫	xeoea
玢	biuo
辊	gdiaee
酐	gcee
銎	qkeie
噻	ssoo
嚯	hseo
堞	djeiie
尥	lwua
嵛	ypuoe
猗	kfeuo
畀	bre
硖	xxeo
逑	qieioe
逯	liaee
偬	zlua
呖	lseuau
塬	yjeu
嫒	rwuo
嬲	nwia
沆	heoeu
溧	leeiai
窭	jpou
缣	jdoue
肭	nwiau
谵	vfuae
鄞	kgeii
鹈	ttou
鹱	htei
黧	lrue
仫	mlu
喱	lseui
曩	nmo
朊	rwee
泔	geeiie
溘	keeie
秫	sveiu
箪	dyo
肀	ydeeii
蒌	lioue
裣	ljuo
赀	zzie
迕	wiuee
酃	lgeo
铋	bkoa
鳙	kco
悱	foi
挹	koiaea
捭	boui
盱	xtee
糇	hzu
胙	zwue
芑	qiaeaa
钎	qkueii
鬟	hjiai
崤	xpuo
欹	kkeuo
澶	ceoei
甾	zhi
瞽	gteie
缡	ldoeu
钇	kkaa
铯	skuaa
鞔	miuai
鲚	jcoeuo
鹪	jtui
嘬	csiaee
庹	tseii
渖	seoo
湔	jeou
燹	xueu
猊	nfu
玎	dieii
籼	xzia
舾	xcei
锊	lkuoou
阊	cgia
岣	gpu
幛	vbo
敫	juui
樘	tkiou
浼	meua
瑷	riuo
甯	njo
癔	kaoe
穸	xpuao
篦	byui
葑	fieiee
蓼	liao
蚍	phea
褊	bjoa
钔	mkoi
钫	fkoe
钯	bkai
铒	rkeii
锼	skuie
锿	rkoe
麇	jfue
嵯	cpou
戗	qkuoa
泮	peou
瀣	xeie
皴	cgao
睃	stao
莩	fiuoo
轫	rdau
逭	hiooa
遄	ciiaie
炱	tuao
篁	hyui
葚	rieiie
褰	qjoo
醍	tciaee
锱	zka
戥	dkia
睥	ptui
筇	qyeie
辚	ldoue
驺	zfu
驽	nfa
髀	bnui
鸺	xtu
哙	ksuoe
桤	qki
楮	ckeieu
濞	beui
炻	sueu
疳	gae
眇	mtiu
砜	fxu
磙	gxo
迓	kieaiu
逄	piuao
醭	bceia
鳇	hcui
仡	glue
唢	ssiou
栌	lkie
殳	sdooo
獍	jfoe
菘	sieiuo
醐	hcei
馇	cseiu
刿	gmiai
垴	njoe
尕	gja
搴	qooo
暝	mmo
殄	tqu
湓	peuoa
磴	dxao
祢	mvua
艚	cceia
葜	qieee
薅	hiau
豉	sjeia
锝	dkiae
镅	mkaie
氙	xiiai
煺	tuae
瓿	bwoe
蟥	hheiie
蹀	daeii
铑	lkeie
黼	feou
杪	mkiu
砬	lxoe
硭	mxe
肜	rwuu
膂	lwoea
蒡	bioeo
蒴	siouea
踟	caue
酽	kcei
鲷	dcua
哏	gsaee
哿	geia
旒	lkueo
殍	pqu
漯	leiaei
猡	lfiai
皤	pcuo
硇	nxu
藁	gioe
锍	lkoeao
鞲	giee
喹	kseuo
姝	swuee
橥	vkuau
溏	teoeu
畋	tru
窆	bpuo
茭	jioeuo
谂	sfuoo
镬	hkeii
髟	bjuuu
鲔	wce
鸲	qtua
吣	qso
窬	ypuoei
缧	ldia
羼	cwoue
赉	lzeo
镓	jkooa
骘	vfai
孥	nha
敉	mzue
涠	weiaee
溲	seu
璩	qiie
筌	qyuo
邳	pgeu
鸸	rteui
垓	gjo
甓	pwa
脔	ltii
艟	ccoeo
苒	riiai
荸	bieio
锪	hkuau
镄	fka
彘	vgue
旄	mkueue
檠	qkeiiu
祆	xvee
胩	kwie
丌	jrui
丨	gnii
丬	qb
丶	vnoo
丿	pnu
亍	cyii
亠	tte
亻	rlii
仂	lla
仉	vlua
仝	tlei
仳	ple
仵	wluee
伛	yleu
佧	klie
佴	rleii
佾	kluoi
侉	kleuo
侑	kleuia
俜	plia
傺	cluao
僬	jluio
儇	xliai
兕	siiai
冁	cpia
冂	jgaa
冖	mjaa
冫	bcee
冱	hcea
凵	qgii
刂	dmi
刭	jmao
刳	kmeu
剀	kmia
剞	jmeu
剡	smo
劁	qmu
劂	jmeuo
劐	hmei
劓	kiii
勹	bda
匚	fga
卩	jgi
卺	jdiau
厶	scooo
叻	lsau
吖	ksou
吲	ksaea
呙	gsia
哓	xsea
哕	ysi
哚	dsuae
哜	jsoe
哳	vseie
唛	mseei
唣	zsui
唪	fseee
唼	ssoeo
喈	jsea
噍	jsui
嚆	hseiio
囗	wgeee
囝	jgai
圉	ygeie
圊	qgee
圬	wjeea
圯	kjaea
圹	kjoeuu
坌	bjuo
坜	ljeuau
坩	gjeii
坫	djie
坭	nja
坶	mjaao
坻	cjua
坼	cjuue
垆	ljie
垌	djia
垤	djea
垧	sjuia
垲	kjiai
垸	yjo
埏	sjuiea
埒	ljuoo
埕	cjia
埘	sjiaee
埚	gjiaei
埝	njuo
埤	pjui
埭	djae
埯	rjeu
埴	vjei
埸	kjiaee
堍	tjua
堙	kjeiai
堠	hjui
塄	ljia
塍	cwouee
塥	gjeiae
墁	mjiae
墚	ljoo
墼	jjeia
夂	vuoo
夼	knui
妁	swuao
妣	bwea
妤	ywa
娈	lwoei
媵	kwou
嫜	vwoe
嫫	mweiii
孑	jhai
孓	jhaio
宀	mjaaa
尜	gjeuo
尢	kwaa
尻	kwua
屣	xwuu
屦	jwuui
屮	ciii
屺	qpaeaa
岈	kpea
岍	qpee
岙	rpueu
岜	bpai
岽	dpea
崦	kpeuo
嵫	zpo
嶷	kpua
巛	chaa
巯	qoao
帱	cbee
帻	zbe
幞	fbi
庳	bsui
廑	jseii
廒	rseei
廨	xsuai
廴	kiooo
廾	giii
弪	jqao
彐	jgeee
彖	tguau
彡	szuu
彳	cpii
徂	cpiae
徼	jpui
忄	xoii
忉	doau
忭	booe
忮	voeia
怃	woee
怊	coau
怍	zouei
怿	koaoe
恝	joee
恧	noeui
悃	koiaei
悛	qoaou
悝	koiaee
悫	qoeie
惝	coiou
慝	toeei
憝	dooei
戋	jrea
戢	jkiaee
戤	gkau
戽	hao
扃	jaiai
扌	soeee
拶	zoaa
挢	joueu
捃	joaee
掊	pooe
掎	joeuo
掭	toeeuo
揎	xoo
揞	rooe
揠	koeia
揲	doeii
揸	voeiu
搋	couui
搌	voaeu
搛	joou
搠	sooue
搦	noaea
摅	soie
撄	koiau
撖	hoaei
撙	zoou
擐	hoiai
擗	poae
攉	hoeo
攮	noei
攴	proo
攵	puo
旰	gmee
昃	zmeu
昝	zmua
晡	bmei
暾	tmoe
杌	wkeua
杩	mkaa
枘	rkia
枧	jkiau
枨	ckuea
柁	dkooa
柃	lkuooa
柒	qkooe
柙	xkiaee
柝	tkuu
柰	nkee
柽	ckaoe
栊	lkeuau
栝	gkueii
栲	kkeieu
栳	lkeieu
桄	gkio
桊	jkoue
桕	jkuie
桫	skoo
桴	fkuo
桷	jkuau
梃	tkue
棰	ckueie
棹	vkiei
棼	fkeiu
椐	jkaeue
椟	dkeiao
椠	qkea
椹	skeii
楗	jkaeee
楱	zkee
榀	pkia
榍	xkae
槠	vkoae
樨	xkaeu
橼	yka
檎	qkuooe
檑	lkeoa
檗	bkae
檫	ckoo
欷	xkuoe
歃	skuei
殂	cqia
殪	kqei
毪	mva
毳	cvue
毵	svao
毹	svuo
毽	jvae
氆	pv
氇	lvu
氍	qvi
氕	piuu
氵	seee
氽	tlia
汆	ceuo
汔	qeue
沔	meeia
沩	weou
沭	seeiuo
沲	teue
泐	leai
泖	meuau
泺	leuai
洇	keiaeu
洎	jeui
洚	jeuao
洧	weeu
洫	xeuiai
浈	veiei
浍	heuo
淠	peia
渫	xeeiie
溱	qeeee
溷	heiaeu
溻	teiae
溽	reeue
滏	feuou
滗	beue
滠	seeii
滹	heie
漤	leeiu
漭	meeiie
漶	heiaei
潋	leuoe
潲	seue
澉	geae
澌	seeiie
瀵	feoue
瀹	yeuoei
灬	buoo
烀	huuou
燠	yuu
爝	juuo
爨	cuui
爿	pyuu
牮	jkuiea
牾	wkeia
牿	gkueie
犋	jkiaee
犏	pko
犭	qfuu
犰	qfua
犴	rfeei
狁	yfao
狃	nfai
狨	rfeeu
狳	yfuo
狴	bfea
狺	kfoee
猁	lfue
猃	xfuoe
猞	sfuoe
猱	nfao
猸	mfai
猹	cfeiu
獒	rfeeie
玟	wioe
珉	miae
珙	gieii
珧	kiuoe
琚	jiaeu
瑗	yiuoo
璁	ciuia
璺	wiui
瓞	ddue
甍	miiaii
甏	bweie
畎	qreu
疋	pao
疒	naee
疔	daeiii
疬	laeua
疰	vaoe
痃	xaoe
痄	vauei
痖	kaei
痦	wae
瘃	vaeu
瘅	daou
瘊	haui
瘌	laeia
瘐	yau
瘕	jaaei
瘗	kaeo
瘥	caoue
瘭	baei
瘰	lai
瘳	caa
瘵	vaua
瘼	mae
癀	haei
癃	laai
癍	baee
皲	jgoa
眄	mteia
眍	kteu
眙	ktaoi
眚	stue
眢	ytua
眭	ste
眵	ctuao
睚	kteue
瞀	mtaoai
瞍	stuie
瞢	miiaii
瞵	ltou
矧	spae
砑	kxea
砘	dxea
砟	vxue
砼	txu
碥	bxoa
碲	dxoe
碹	xxo
磉	sxa
磲	qxo
礅	dxoei
礓	jxei
礞	mxei
礤	cxei
礻	svoo
祓	fve
祧	tvu
禊	xveee
禚	vvou
秕	bve
秭	zvua
稂	lvoa
稃	fvu
稆	lvi
筅	xyue
筘	kyei
筚	byea
筢	pyeie
筲	syio
筻	gyeia
箅	byi
箐	qyeei
箜	kyoo
箢	yyo
箦	zyee
箨	tye
箬	rye
篌	hyuia
篚	fyei
篥	lyeia
篼	dyui
簋	gya
簏	lyoeu
簖	dyou
籀	vyeieu
粞	xzei
糈	xza
糌	zzua
糍	czou
糗	qz
糨	jza
糸	mdoo
絷	vdeie
綮	qdoa
纛	ddee
纟	sdeee
纩	kdoe
绁	xdeii
绂	fdeu
绋	fda
绐	ddao
绗	hduu
绠	gdeia
绡	xdio
缋	hdi
缌	sdiae
缍	dduei
缏	bdui
缑	gdui
缲	qdia
缳	hdia
缵	zdue
罨	kyeu
羝	dkuae
翥	vqei
翮	hqe
耋	djuu
耒	lyooo
耔	zya
耖	cyiu
耜	syia
耠	hyuo
耢	lyeiio
耥	tyio
耧	lyoue
耩	jyeei
耱	myo
耵	dgei
聍	ngoo
聱	rgeeie
胬	nwaoi
胲	hwoe
脎	swuoe
脒	mwou
脞	cwuo
脬	pwuo
脶	lwiaei
腈	jweeie
腙	zwoo
腠	cweee
腧	swuoei
腩	nwei
腽	wwia
膣	vwoo
膦	lwoue
膪	cwoeo
臌	gweie
舁	yceu
舄	xcua
舡	cceie
舣	kcou
舭	bcea
舯	vci
舳	vcia
舴	zcu
艋	mca
艨	mce
艴	fqui
艹	ciiii
芈	mai
芘	piea
芴	wiuau
苈	lieuau
苘	qiiai
苠	miaea
茆	miuau
茇	bieu
茈	ciiei
茌	ciuie
茕	qioa
茚	kiuae
茛	giae
茳	jiooee
茺	cioea
茼	tiia
荇	xiuu
荑	tiea
荜	biea
荦	lkeii
荬	miaoo
荮	viaa
莛	tiueie
莨	lioaee
莰	kieieu
莳	siiae
莶	xiuo
菝	bieie
菡	hiai
菥	xiei
菪	dioo
菰	giai
萁	qieiie
萆	biuiae
萏	diuau
萜	tiiai
葙	xieiu
葳	wieue
葶	tioe
葸	xiiae
蒇	cieui
蒈	kieaua
蒉	kiiaei
蒎	piooe
蒗	lioo
蒹	jiou
蒽	riiaeu
蓁	viee
蓊	wiuo
蓍	sieieu
蓐	rieue
蓠	lioeu
蓣	yiao
蓥	kkeiio
蓰	xiuui
蔌	sieia
蔟	cioeau
蔸	diuia
蔹	liuoe
蕈	xieia
蕞	zii
蕤	rieua
蕹	wioea
蕺	jiiaee
蕻	hieie
薤	xieua
薷	rieo
蘧	qiiea
虍	hraa
蚵	hheiae
蚺	rhiai
蛸	shio
蜞	qheii
蜩	thua
蜱	phui
蜾	ghiae
蝓	yhu
蝤	qhoue
蝥	mhaoa
蝰	kheu
蝻	nhei
蝾	rhei
螋	shuiea
螓	qheee
螗	thoe
螵	phei
蟓	xhuai
蠃	lhoea
衤	kjoo
裒	ptuie
褙	bjie
襞	bjae
襦	rjeo
襻	pjeiu
觇	ceie
觋	xeeiuo
觌	deeia
觏	geee
觖	jxa
觚	gxuu
觜	zxi
觫	sxeia
訾	zfie
謦	qfeie
讠	kfaa
谫	jfou
谮	zfea
谳	kfei
豇	jjeiee
豳	bpe
豸	vguu
貅	xguie
貊	mgeui
貔	pgui
貘	mgei
贳	szei
贶	kzi
赆	jzae
赇	qze
赕	dzo
赙	fzeia
趑	zuo
趱	zuu
趵	baua
趼	jaeeu
跖	vaeui
跬	kaeie
跽	jaaea
踣	baoe
踬	vauu
踺	jaaee
蹁	paoa
蹯	fauo
躐	laaa
躔	caoeu
躜	zau
躞	xaoee
軎	wdi
轵	vdiae
轷	hduou
轹	lduai
轺	kdau
轾	vdea
辁	qdu
辂	lduaoi
辋	wdia
辶	ciooo
迮	ziue
遘	gieei
邗	hgeei
邡	fkai
邴	bgei
邶	bgie
邾	vguee
郄	qguoe
郇	hguai
郐	kguo
郗	xguoe
郜	gguei
郫	pguia
鄹	zge
酎	vce
酏	kcai
酞	tce
酡	tcoo
酤	gceii
酲	ccia
酴	tcuo
酹	lcuo
酾	sceia
醅	pco
醌	kciae
醑	xcai
钅	jkaa
钆	gkaa
钐	skuuu
钬	hkou
钲	vkeiei
钶	kkeia
钷	pkei
钸	bkeuia
钽	tkiaee
铈	skoeia
铊	tkoo
铌	nkae
铕	kkeui
铖	ckeua
铗	jkeo
铘	kkeai
铙	nkea
铞	dkiaei
铟	kkiaeu
铥	dkuei
铪	hkuo
铫	kkuo
铴	tkooe
铷	rkau
铹	lkeiio
铼	lkeou
铽	tkeo
锇	rku
锎	kkoi
锓	qkaee
锔	jkaeua
锖	qkeei
锘	nkeii
锞	kkiaee
锫	pkoe
锬	tkouu
锾	hkuoo
镎	nkuo
镔	bkooa
镗	tkiouo
镘	mkia
镙	lkiaei
镝	dkoe
镟	xkoeau
镡	xkeia
镤	pkii
镥	lkuaia
镦	dkoei
镨	pkou
镩	ckooa
镪	qkaea
镱	kkoeo
镲	ckooau
阚	kgae
阝	fgii
阢	wgeu
阼	zgue
阽	dgie
陔	ggoea
陧	ngi
陬	zgei
陴	pguiae
隈	wgia
隰	xgiae
雩	yxe
霈	pxoo
霪	kxoo
顸	hhee
颃	hho
颟	mheiie
颡	shao
颥	rheoai
飑	bjua
饣	ssaaa
馘	gpeu
驵	zfia
骀	tfao
骐	qfeii
骒	kfiaee
骖	cfao
骝	lfuao
骟	sfoa
骢	cfui
骣	cfae
骺	hnu
髫	tjau
髹	xjui
鬏	jjue
鬲	griae
鲐	tca
鲒	jceie
鲕	rce
鲞	xcou
鲣	jcii
鲥	sciae
鲦	tcua
鲩	hcoo
鲭	vcee
鲳	cciae
鲴	gcia
鲵	ncui
鲺	sca
鲻	zca
鲼	fce
鲽	dceii
鳆	fcue
鳋	scao
鳐	kcuo
鳓	lceii
鳘	mcuea
鳜	gceu
鹇	xtoi
鹋	mteii
鹎	btui
鹛	mtai
鹣	jtou
麈	vfoee
麴	qgua
黉	hjoae
黟	kru
黥	qroei
黪	crao
黹	veoui
黻	feoui
鼢	fpuo
鼯	wpei
鼷	xpui
鼽	qiuaa
齄	vieiu
龠	ylei
啰	lsiai
嗞	zsou
嚱	xsie
嬛	hwia
屌	dwiaei
濛	meeiio
玦	jiaeuo
臜	rwuei
齁	hiuai