报	b;
必	b,
便	b.
北	b/
传	c;
存	c,
城	c.
称	c/
当	d;
定	d,
等	d.
代	d/
反	f;
放	f,
关	g;
感	g,
格	g.
共	g/
合	h;
化	h,
活	h.
何	h/
加	j;
军	j,
结	j.
建	j/
应	k;
口	k,
眼	k.
议	k/
两	l/
流	l.
连	l,
李	l;
命	m;
满	m/
内	n;
期	q;
却	q,
取	q.
七	q/
任	r;
安	r,
让	r.
热	r/
什	s;
世	s,
声	s.
数	s/
体	t;
太	t,
图	t.
推	t/
主	v;
只	v,
长	v.
战	v/
万	w;
望	w,
未	w.
微	w/
小	x;
想	x,
性	x.
先	x/
远	y;
做	z;
则	z,
怎	z.
字	z/
专	vy