的	dkuaoo	dk
一	keeeee	ke
是	fkeieu	fk
不	neuioo	ne
了	laaiii	la
在	cleuie	cl
人	sjoooo	sj
有	kseuia	ks
我	siueie	si
他	vjaiaa	vj
这	gnoeuo	gn
个	rjiiii	rj
们	tjoiaa	tj
中	giiiii	gi
来	leouei	le
上	foeeee	fo
大	dioooo	di
为	souaoo	so
和	whiaee	wh
国	rheeie	rh
地	dlaiaa	dl
到	dmeaoe	dm
以	kjaouo	kj
说	ffouia	ff
时	fkeioo	fke
要	kwauee	kw
就	jfiaei	jf
出	zvaiii	zv
会	wjeeao	wj
可	cieiae	ci
也	kaiaaa	ka
你	xjuaiu	xj
对	ddeioo	dd
生	fxeeie	fx
能	xliaee	xl
而	peuiai	pe
子	cheeee	ch
那	xxaeeu	xx
得	dtiaee	dt
于	kviiii	kv
着	gsiaee	gs
下	hoeioo	ho
自	coeeee	co
之	goaooo	go
年	xueeie	xu
过	rneioo	rn
发	mdauao	md
后	wiuuei	wi
作	cjueie	cj
里	lseeee	ls
用	kfiiii	kf
道	dnoueu	dn
行	hteeii	ht
所	bluuae	bl
然	syuaoo	sy
家	jpeuau	jp
种	ghiaei	gh
事	feiaea	fe
成	zieuaa	zi
方	mguuuu	mg
多	dhuaoo	dh
经	jcaoei	jc
么	tluaoo	tl
去	qlaooo	ql
法	moeiea	mo
学	hsaiee	hs
如	smiaee	sm
都	dxeieu	dx
同	vheiae	vh
现	hriaua	hr
当	dsaeee	ds
没	touaao	to
动	dweeao	dw
面	teuiai	te
起	quaeaa	qu
看	cyueeu	cy
定	dpeieu	dp
天	vvoooo	vv
分	mrauuu	mr
还	wneuio	wn
进	jneeui	jn
好	wmaiee	wm
小	hsoooo	hso
部	nxoeou	nx
其	qkoooo	qk
些	hvieie	hv
主	groeei	gr
样	kdouee	kd
理	lriaee	lr
心	hwoooo	hw
她	vmaiaa	vm
本	ndeeee	nd
前	qreiae	qr
开	cvuiii	cv
但	djiaee	dj
因	kheuoo	kh
只	giuooo	giu
从	pjuooo	pj
想	hweiuo	hwe
实	fpooeu	fp
日	skeeee	sk
军	jpeaei	jpe
者	gliaee	gl
意	kgiaee	kg
无	svuaaa	sv
力	lwuuuu	lw
它	vpuaaa	vp
与	keaeee	kea
长	gueaoo	gu
把	ngaiea	ng
机	jduaaa	jd
十	fliiii	fl
民	taeaea	ta
第	duaeai	du
公	rraooo	rr
此	pduaaa	pd
已	kraeaa	kr
工	rieeee	ri
使	fjeiae	fj
情	qweeie	qw
明	tkuaee	tk
性	hwueei	hwu
知	gaiaee	ga
全	qjeeie	qj
三	bveeee	bv
又	kdoooo	kdo
关	rreeuo	rre
点	doeooo	do
正	gdeiei	gd
业	kleeee	kl
外	shiooo	sh
将	jsuaoe	js
两	leiauo	lei
高	rfaeia	rf
间	jtiaee	jt
由	kkiaei	kk
问	stiaee	st
很	wtaeea	wt
最	ckeiie	ck
重	gvueia	gv
并	nreeui	nr
物	sxuauu	sx
手	fgiiii	fg
应	kbooue	kb
战	giieia	gii
向	hiuiai	hi
头	viooeu	vi
文	sfoooo	sf
体	vjeiuo	vje
政	gyeiei	gy
美	tseuoo	ts
相	hdiaee	hd
见	jgaaaa	jg
被	npauia	np
利	lhiiii	lh
什	fjeiii	fje
二	pveeee	pv
等	dueiee	due
产	znuuuu	zn
或	weeauo	we
新	hloeou	hl
己	jraaaa	jr
制	gmueei	gm
身	fcuuuu	fc
果	rkeiuo	rk
加	jwiaee	jw
西	heeeee	he
斯	bkuuei	bk
月	kseeee	kse
话	wfueii	wf
合	wjeiae	wje
回	whiaee	whi
特	vxeiee	vx
代	djeaoo	dje
内	xhauoo	xh
信	hjoeee	hj
表	nveeie	nv
化	wjuaaa	wju
老	llaaaa	ll
给	rcuoei	rc
世	fviiea	fv
位	sjoeou	sjo
次	pzuauo	pz
度	dbeiie	db
门	ttaaaa	tt
任	sjueie	sju
常	zziouo	zz
先	hxuaaa	hx
海	woueaa	wo
通	vnaoia	vn
教	jyeieu	jy
儿	pfaaaa	pf
原	kcuiae	kc
东	deaiuo	de
声	flaieu	fla
提	vgiaee	vg
立	lneeee	ln
及	juaooo	ju
比	nsaaaa	ns
员	kiiauo	ki
解	jvauue	jv
水	fooooo	foo
名	thiaee	th
真	gliaee	gli
论	lfuoua	lf
处	zliooo	zl
走	cuoooo	cu
义	kouooo	ko
各	rliaee	rl
入	suoooo	su
几	jhaaaa	jh
口	cieeee	cie
认	sfuooo	sfu
条	vleiuo	vl
平	yeouei	ye
系	hcuaao	hc
气	qcaaaa	qc
题	vziaee	vz
活	woueii	wou
尔	psuaiu	ps
更	reiaee	re
别	nmiaea	nm
打	dgeiii	dg
女	xmeeee	xm
变	nfiiuo	nf
四	bhuaaa	bh
神	fhiaee	fh
总	cwouia	cw
何	wjeiae	wjei
电	dkaaaa	dka
数	fyouei	fy
安	ppauee	pp
少	fsuuuu	fs
报	ngaiao	nga
才	peiuuu	pei
结	jceiei	jce
反	mduuao	mdu
受	fjoaao	fjo
目	tyeeee	ty
太	vioooo	vio
量	lkeiae	lk
再	ceiaie	ce
感	rweuei	rw
建	jnaeee	jna
务	slauuu	sl
做	cjeiia	cje
接	jgoeou	jgo
必	nwoooo	nw
场	zlauuu	zla
件	jjueei	jj
计	jfeiii	jfe
管	ruooai	ru
期	qkuaee	qku
市	ffiaii	ffi
直	gliaee	glia
德	dteuia	dte
资	cfoeua	cf
命	tjeiae	tje
山	fqiiii	fq
金	jaeeee	ja
指	gguaia	gg
克	cliaeu	cli
许	hfueei	hf
统	vcoeao	vc
区	qhuooo	qh
保	njiaee	nj
至	gleaoe	gle
队	dxuooo	dxu
形	hgeeui	hg
社	fheiee	fhe
便	njeiae	nje
空	cseiee	cs
决	jzaeuo	jz
治	goaoia	goa
展	gqeiie	gq
马	tpeeee	tp
科	chooei	cho
司	biaeia	bi
五	seiaee	se
基	jkeiee	jk
眼	kyaeea	ky
书	faaioo	fa
非	mieeei	mi
则	cfiiii	cfi
听	viuuei	viu
白	nkeeee	nk
却	qxeiea	qx
界	jbuoui	jb
达	dneuoo	dne
光	rseuaa	rs
放	mgueuo	mgu
强	qhiaei	qhi
即	jlaiii	jl
像	hjuaia	hju
且	qiaeee	qi
难	xduioe	xd
权	qdaooo	qd
思	bboaoo	bb
王	sreeee	sr
象	hmaiae	hm
完	speeua	sp
设	ffuaao	ffu
式	fieeie	fi
色	bmaiea	bm
路	lquaoi	lq
记	jfaeaa	jfa
南	xliaou	xli
品	yiiaei	yi
住	gjoeei	gj
告	rxiaee	rx
类	lmeuoo	lm
求	qeioeu	qe
据	jgaeue	jga
程	zhiaee	zh
北	nieeua	ni
边	nnauoa	nn
死	bpuaaa	bp
张	ghueao	ghu
该	rfoeau	rfo
交	jfuouo	jfu
规	rgeeuo	rg
万	seauuu	sea
取	qxaooo	qxa
拉	lgoeou	lg
格	rduaoi	rd
望	sroeau	sro
觉	jsiaua	jsi
术	fdoooo	fd
领	lzuooa	lz
共	rreiie	rrei
确	qtuaua	qt
传	zjeeao	zj
师	fziuei	fz
观	rdiaua	rdi
清	qoeeie	qo
今	jjoaaa	jjo
切	qmeaau	qm
院	kxooae	kx
让	sfieee	sfi
识	ffiaeu	ffia
候	wjiaeu	wji
带	dzeiii	dz
导	dreioo	dr
争	gmaeei	gma
运	kneeao	kn
笑	huueuo	hu
飞	mauooo	ma
风	mxoooo	mx
步	ndiuuu	ndi
改	rreuoo	rreu
收	fyaiue	fya
根	rdaeea	rda
干	rviiii	rv
造	cnueie	cn
言	kfeeee	kfe
联	lxouee	lx
持	zgeiee	zg
组	cciaee	cc
每	tnueaa	tn
济	jooeuo	jo
车	zkiiii	zk
亲	qneiuo	qn
极	jduaoo	jdu
林	ldeiuo	ld
服	msaiao	ms
快	cwaeuo	cwa
办	nwoooo	nwo
议	kfouoo	kfo
往	stoeei	sto
元	kvuaaa	kvu
英	kviaeu	kvi
士	fleiee	fle
证	gfeiei	gf
近	jnuuei	jnu
失	fueeuo	fu
转	gkeeao	gk
夫	mveuoo	mv
令	ljooao	lj
准	gzuioe	gz
布	nzeuia	nz
始	fmaoia	fm
怎	cwueie	cwu
呢	xiaeuu	xi
存	pheuia	ph
未	sveiuo	sve
远	kneeua	kne
叫	jiaiii	ji
台	vliaee	vli
单	driaee	dri
影	kgiaee	kgi
具	jriaee	jri
罗	leuaoo	leu
字	cpaiee	cp
爱	pjoaeu	pjo
击	jveiai	jve
流	looeao	lo
备	nliaei	nl
兵	nruiei	nru
连	lneaei	lne
调	dfuaei	df
深	fooauo	fooa
商	ffouia	ffo
算	buiaee	bu
质	gfuuei	gfu
团	vheiuu	vhe
集	jeeiuo	je
百	neuiae	neu
需	hqeuia	hq
价	jjuoui	jju
花	wvuiua	wv
党	dfiouo	dfi
华	wluiua	wl
城	zleuaa	zle
石	fteeee	ft
级	jcuaoo	jcu
整	gdeiae	gde
府	mbuiei	mb
离	lfoaii	lfo
况	cziaeu	cz
亚	kleiio	kle
请	qfeeie	qf
技	jgeiao	jge
际	jxeeiu	jx
约	kcuaoo	kcu
示	fhoooo	fho
复	mlueia	ml
病	nbeiau	nb
息	hooaoo	hoo
究	jsuaaa	jsu
线	hceeau	hce
似	fjaouo	fja
官	rpiaea	rp
火	wyoooo	wy
断	dlouei	dlo
精	jmeeie	jm
满	toeiie	toe
支	glaooo	gla
视	fhiaua	fhi
消	hoioui	hoi
越	kueaau	ku
器	qiiaee	qii
容	ssuoia	ss
照	gyiaee	gyi
须	hgeuia	hge
九	juaaaa	jua
增	clouea	clo
研	kteeui	kt
写	hpeaee	hp
称	zhuaiu	zhu
企	qjieie	qji
八	nroooo	nro
功	riauuu	ria
吗	tiaaee	ti
包	ntaeaa	nt
片	ycaaaa	yc
史	fiuooo	fiu
委	shauoo	sha
乎	wuouei	wu
查	zdiaee	zd
轻	qkaoei	qka
易	kkuauu	kku
早	ckeiii	cke
曾	priaio	pr
除	zxuoee	zx
农	xpauau	xp
找	ggeauo	gge
装	gpoeie	gp
广	rboeuu	rb
显	hkiiou	hk
吧	niaiea	nia
阿	pxeiae	px
李	ldaiee	lda
标	ndeeiu	nde
谈	vfouuo	vf
吃	ziueaa	ziu
图	vhuaoo	vhu
念	xwuooa	xw
六	lfuooo	lfu
引	khiiii	khi
历	lcauuu	lc
首	freuia	fr
医	khueeu	khu
局	jqaiae	jq
突	vseuoo	vs
专	gveaoo	gve
费	mfaeau	mf
号	wieaaa	wie
尽	jqoooo	jqo
另	liauuu	li
周	gheiei	ghe
较	jkoeuo	jko
注	gooeei	goo
语	kfeiae	kfei
仅	jjaooo	jja
考	claaaa	cla
落	lvooeu	lv
青	qqeeee	qq
随	bxeuia	bx
选	hnueie	hn
列	lpiiii	lp
武	sdeeie	sd
红	wceiee	wc
响	hiuiai	hiu
虽	biiaei	bii
推	vguioe	vgu
势	fweieu	fw
参	pleuou	pl
希	hzuoeu	hz
古	rliaee	rli
众	gjuouo	gju
构	rduaao	rdu
房	mboeau	mbo
半	noueei	no
节	jvaiii	jva
土	vleeee	vle
投	vguaao	vgua
某	tveeiu	tv
案	pdooaa	pdo
黑	wloooo	wlo
维	scuioe	sc
革	rkiiii	rki
划	wiiiii	wii
敌	dyueii	dy
致	gyeaoe	gye
陈	zxeaiu	zxe
律	ltaeee	lt
足	cqoooo	cq
态	vweuoo	vw
护	wgoaeu	wg
七	qeaaaa	qea
兴	hseuoo	hse
派	youuua	yo
孩	whoeau	who
验	kpuoeo	kp
责	cfeeie	cfe
营	kvoaia	kvo
星	hkueei	hku
够	rtiaeu	rt
章	ggeiii	ggei
音	kgeeee	kge
跟	rqaeea	rq
志	gloaoo	glo
底	dbuaea	dbu
站	gnieia	gni
严	kceiio	kce
巴	naaaaa	na
例	ljeuao	lje
防	mxoeau	mxo
族	cgueue	cg
供	rjeiie	rje
效	hyoeuo	hy
续	hceiao	hcei
施	fgueai	fgu
留	lbuaoa	lb
讲	jfeeui	jfee
型	hleeui	hle
料	lmooei	lmo
终	gcuaoo	gc
答	duuoei	duu
紧	jciiao	jci
黄	wreiie	wr
绝	jcuaai	jcua
奇	qieiae	qie
察	zpuaoo	zp
母	tnoooo	tno
京	jfiaei	jfi
段	dhuiee	dhu
依	kjoeua	kjo
批	ygeaua	yg
群	qsaeeu	qs
项	hieuia	hie
故	ryeiia	ry
按	pgooaa	pg
河	woeiae	woe
米	tmoooo	tm
围	sheeai	she
江	joeiee	joe
织	gciaeu	gci
害	wpeeei	wp
斗	djiiii	dji
双	fdaooo	fda
境	jloeou	jlo
客	cpuaoi	cpu
纪	jcaeaa	jca
采	pjeiuo	pje
举	jseuoe	jse
杀	fduoei	fdu
攻	riueuo	riu
父	mwoooo	mw
苏	bvauoo	bva
密	tqooao	tq
低	djuaea	dju
朝	zseiia	zs
友	kdeuao	kde
诉	bfuuei	bf
止	gdeeee	gdee
愿	kweuui	kwe
细	hciaei	hci
千	qlueii	qlu
值	gjeiia	gje
仍	sjauuu	sja
男	xbauuu	xb
钱	qaeeau	qa
破	ytauia	yt
网	shuouo	shu
热	syeieu	sye
助	gwiaee	gw
倒	djeaoe	djea
育	kfaoia	kfa
属	fqaeia	fqa
坐	cluouo	clu
帝	dfouoa	dfo
限	hxaeea	hxa
船	zruaia	zr
脸	lsuoeo	lsu
职	gxiaeu	gx
速	bneiae	bn
刻	cmoeau	cm
乐	lsuaiu	lsua
否	mieuio	mie
刚	rmiauo	rm
威	sieuea	sie
毛	tuaaaa	tu
状	gseuoo	gse
率	lfaaoo	lfa
甚	fkaaaa	fka
独	dkiaei	dki
球	qreioe	qre
般	nruaao	nrua
普	yreiio	yr
怕	ywuiae	yw
弹	dhouia	dho
校	hdoeuo	hdo
苦	cveiia	cve
创	zmuoaa	zm
假	jjaeie	jjae
久	juaooo	juao
错	paeiie	pa
承	zaieee	za
印	kxuaea	kxu
晚	skuaia	sku
兰	lreeee	lre
试	ffeeie	ffe
股	rsuaao	rsu
拿	xjeiae	xje
脑	xsoeuo	xs
预	kzaoai	kz
谁	ffuioe	ffui
益	kreuoi	kre
阳	kxiaee	kxi
若	sveuia	sveu
哪	xiaeeu	xia
微	stiaie	sti
尼	xquaaa	xq
继	jcouei	jco
送	bnouee	bno
急	jwuaae	jwu
血	hheeee	hh
惊	jwoeia	jwo
伤	fjueau	fju
素	bceeie	bc
药	kvaaeu	kva
适	fnueii	fn
波	noauia	noa
夜	kfuiua	kfu
省	fyiuou	fyi
初	zpauuu	zpa
喜	hliaeo	hli
卫	sxeeee	sxe
源	koeuui	koe
食	fboooo	fb
险	hxuoeo	hxu
待	dteiee	dtei
述	fneiuo	fne
陆	lxeeia	lxe
习	hzaoee	hza
置	geeiia	ge
居	jqeiia	jqe
劳	lweiio	lwe
财	pfeiuu	pfe
环	wreuio	wre
排	ygieee	ygi
福	mheiae	mh
纳	xciauo	xc
欢	wduauo	wd
雷	lqiaei	lqi
警	jfeiiu	jfei
获	wvuaue	wvu
模	tdeiii	td
充	zfaoua	zf
负	mmiauo	mm
云	kvaooo	kvao
停	vjoeia	vjo
木	tdoooo	tdo
游	kooeau	koo
龙	lfoooo	lfoo
树	fdaoei	fdao
疑	kduaue	kdu
层	pqeeao	pq
冷	lzuooa	lzu
洲	goouoi	goou
冲	zziaei	zzi
射	fceioo	fce
略	lbuaoi	lbu
竟	jguaaa	jgu
范	mvooea	mvo
句	jtiaee	jti
室	fpeaoe	fpe
异	kreuii	kreu
激	jouiae	jou
汉	woaooo	woa
村	pdeioo	pde
哈	wiuoei	wiu
演	koooae	kooo
策	pueiai	pu
简	juoiai	juo
卡	coeioo	coe
罪	ceieee	cei
判	ymouee	ym
担	dgiaee	dgi
州	gouoio	gou
静	jquaae	jqu
退	vnaeea	vna
既	jleaua	jle
衣	kpoooo	kpo
您	xwuiua	xwu
宗	cpeeiu	cpe
积	jhiaeu	jhi
余	kjeeiu	kje
痛	vbaoia	vb
检	jduoeo	jduo
差	zseiee	zse
富	mpeiae	mp
灵	lrouuo	lro
协	hlauoo	hla
角	jviiii	jvi
占	goiaee	goi
配	ywaeaa	ywa
征	gteiei	gt
修	hjiuao	hji
皮	yvoooo	yv
挥	wgoaea	wgo
胜	fsueei	fsu
降	jxuaoe	jxu
阶	jxuoui	jxuo
审	fpiaee	fpi
沉	zooaua	zo
坚	jliiao	jli
善	fsouei	fso
妈	tmaaee	tma
刘	lfiiii	lfi
读	dfeiao	dfe
啊	piaiei	pi
超	zuauia	zu
免	tmiaeu	tmi
压	kceieo	kcei
银	kaaeea	kaa
买	tiaooe	tia
皇	wkeeie	wk
养	kreeeu	kree
伊	kjaeeu	kja
怀	wweuio	ww
执	gguaoo	ggu
副	mmeiae	mme
乱	luaaaa	lu
抗	cgoeua	cgo
犯	mkaaaa	mk
追	gnuiae	gnu
帮	nzeeeu	nze
宣	hpeiae	hpe
佛	mjaeau	mj
岁	bquaoo	bq
航	wroeua	wro
优	kjeuao	kjeu
怪	rwaoei	rwa
香	hhiaee	hhi
著	gveieu	gvei
田	vbeeee	vbe
铁	vaueeu	va
控	cgooau	cgoo
税	fhouia	fhou
左	cieuei	cieu
右	kieuia	kie
份	mjuoau	mju
穿	zseaiu	zsea
艺	kvaaaa	kvaa
背	nsieeu	nsi
阵	gxeaei	gxe
草	pviaee	pvi
脚	jseiea	jsei
概	rdaeea	rdae
恶	pweiio	pw
块	claeuo	clae
顿	dzeaia	dze
敢	ryaeii	rya
守	fpeioo	fpei
酒	joeiau	joei
岛	dquaoa	dq
央	kiiaeu	kii
托	vgueaa	vgue
户	wbuuuu	wb
烈	lyeuao	ly
洋	koouee	koou
哥	rieiae	rie
索	bloaaa	blo
胡	wseiia	ws
款	cbeiee	cb
靠	cxiaei	cx
评	yfeoue	yf
版	ncuuao	nc
宝	npeeie	npe
座	cbuouo	cbu
释	fuaoee	fua
景	jkoeia	jkoe
顾	rzeuaa	rz
弟	draeai	dra
登	dvaeou	dv
货	wfuiua	wfu
互	weaaee	wea
付	mjeioo	mje
伯	njuiae	nju
慢	twiaee	tw
欧	pbeuoa	pb
换	wguaia	wgu
闻	steiie	ste
危	smeuaa	sme
忙	twoeaa	two
核	wdoeau	wdo
暗	pkoeou	pk
姐	jmiaee	jmi
介	jjuiii	jjui
坏	wleuio	wle
讨	vfeioo	vfe
丽	leiaoi	leia
良	lloaee	llo
序	hbaoai	hb
升	fvueui	fvu
监	jsiiue	jsii
临	liiueo	lii
亮	lfiaeo	lfia
露	lqiaei	lqia
永	kouooo	kou
呼	wiuoue	wiuo
味	sieeiu	siee
野	ksaoai	ksa
架	jdauia	jda
域	kleiae	klei
沙	foiuou	foi
掉	dgieia	dgie
括	cgueii	cgu
舰	jriaua	jria
鱼	kzeeee	kze
杂	cduaei	cd
误	sfiaee	sfia
湾	sooeii	soo
吉	jliaee	jlia
减	jzeuei	jze
编	ncoaeu	nco
楚	zdeiuo	zde
肯	cdiaee	cdi
测	poiauo	po
败	nfueuo	nfu
屋	sqeaoe	sq
跑	yquaae	yq
梦	theiuo	the
散	byeiie	by
温	soiaee	soi
困	cheiuo	che
剑	jmuoeo	jmu
渐	joeaie	joea
封	mceiee	mc
救	jyeioe	jye
贵	rfiaei	rfi
枪	qduoaa	qdu
缺	qyaeuo	qy
楼	ldouei	ldo
县	hliaee	hlia
尚	fsiaia	fsi
毫	wfiaeo	wfi
移	khuaou	khua
娘	xmoaee	xmo
朋	ysuaee	ys
画	weiaei	wei
班	nrouee	nrou
智	gkueeu	gku
亦	kfuiuo	kfui
耳	pxeeee	pxe
恩	pwiaeu	pwi
短	daeiae	da
掌	ggiouo	ggi
恐	cweieu	cwe
遗	kniaei	kni
固	rheiia	rhe
席	hbeiie	hbe
松	bduoao	bd
秘	thoaou	tho
谢	hfuiae	hfu
鲁	lziaee	lzi
遇	kniaee	knia
康	cbaeei	cba
虑	lsoaoo	lso
幸	hlouee	hlo
均	jluaoe	jlu
销	haioui	ha
钟	gaiaei	gai
诗	ffeiee	ffei
藏	pveuae	pve
赶	rueeii	rue
剧	jmaeue	jma
票	yweeiu	ywe
损	bgiaei	bg
忽	wwuauu	wwu
巨	jhaeee	jha
炮	yyuaae	yy
旧	jkiiae	jki
端	dniaie	dni
探	vgoauo	vgo
湖	woeiia	woei
录	lrioeu	lri
叶	kieiii	kiei
春	zkeeeu	zke
乡	hauuuu	hau
附	mxuiei	mxu
吸	hiuaoo	hiua
予	kaoaii	kao
礼	lhaaaa	lha
港	roeiie	ro
雨	kqoooo	kq
呀	kieaiu	kiea
板	nduuao	ndu
庭	vbueie	vbu
妇	mmaeee	mma
归	rriuae	rri
睛	jyeeie	jyee
饭	mbuuao	mbu
额	pziaee	pzi
含	wjoaia	wjo
顺	fzuiie	fzu
输	fkuoei	fku
摇	kguoou	kgu
招	ggauia	gga
婚	wmuaea	wmu
脱	vsouia	vso
补	npiooo	npi
谓	sfiaei	sfiae
督	dyieei	dyi
毒	dneeie	dnee
油	koiaei	koi
疗	lbaiii	lba
旅	lgueua	lgu
泽	coaoee	coa
材	pdeiuu	pdei
灭	tyeouu	tye
逐	gneuau	gne
莫	tviaee	tvi
笔	nuueea	nu
亡	sfaaaa	sfa
鲜	hzouee	hzo
词	pfaeia	pfa
圣	fdeiee	fde
择	cgaoee	cga
寻	hreioo	hre
厂	zcuuuu	zc
睡	fyueie	fyu
博	nleiae	nle
勒	lkauuu	lka
烟	kyiaeu	kyi
授	fguoou	fguo
诺	xfeiie	xf
伦	ljuoua	lju
岸	pqeuee	pqe
奥	piuiao	piu
唐	vbaeei	vba
卖	tlaooe	tla
俄	pjueie	pju
炸	gyueie	gyu
载	ckeiee	ckei
洛	louaoi	lou
健	jjaeee	jjaee
堂	vliouo	vlio
旁	yfuoao	yfu
宫	rpiaei	rpi
喝	wiiaee	wiia
借	jjeiie	jje
君	jiaeeu	jia
禁	jheiuo	jhe
阴	kxuaee	kxua
园	kheeua	khe
谋	tfeiie	tf
宋	bpeiuo	bpe
避	nnaeui	nna
抓	gguuio	gguu
荣	sdeiio	sde
姑	rmeiia	rme
孙	bhiuoo	bhi
逃	vnuoea	vnu
牙	keaiuu	keai
束	feiaei	fei
跳	vquoea	vq
顶	dzeieu	dzei
玉	kroooo	kro
镇	gaeiia	gae
雪	hqaeee	hqa
午	sueeii	sue
练	lceaau	lce
爷	kwaiii	kwa
迫	ynuiae	yn
篇	yuoaeu	yu
肉	shuouo	shuo
嘴	ciieie	cii
馆	rbooai	rbo
遍	nnoaeu	nno
凡	mhoooo	mho
础	ztaiia	zt
洞	doiaei	doi
卷	jreeuo	jre
坦	vliaee	vlia
牛	xxiiii	xxi
宁	xpeiii	xpe
纸	gcuaea	gcu
诸	gfeieu	gfe
训	hfuiii	hfui
私	bhaooo	bha
庄	gbeiee	gb
祖	chiaee	chi
丝	beaaaa	be
翻	mzuoue	mz
暴	nkeiie	nke
森	bdeiuo	bde
塔	vleiiu	vlei
默	tleuoo	tle
握	sgaeue	sg
戏	hdeauo	hde
隐	kxuaae	kxuaa
熟	fyoeia	fyo
骨	rweeee	rwe
访	mfoeau	mfo
弱	shoeae	sho
蒙	tieiio	tie
歌	rbeiae	rbe
店	dbieia	dbi
鬼	rloooo	rlo
软	skuauo	skua
典	driaei	dria
欲	kbuouo	kbu
萨	bvaioe	bvai
伙	wjouuo	wjou
遭	cneiae	cne
盘	yriaii	yri
爸	nwaiea	nwa
扩	cgoeuu	cgoe
盖	rsiaii	rsi
弄	xreuii	xr
雄	heeuao	hee
稳	shuaae	shua
忘	swoeao	sw
亿	kjaaaa	kjaa
刺	pmeiai	pm
拥	kguaee	kgua
徒	vteiei	vt
姆	tmaaoe	tmaa
杨	kdauuu	kda
齐	qfuiii	qfu
赛	bfooae	bfo
趣	queiie	que
曲	qkiaei	qki
刀	dmuuuu	dmu
床	zbeiuo	zb
迎	knuaai	knu
冰	nziauo	nzi
虚	hsiiou	hsi
玩	sreeua	sre
析	hduuei	hdu
窗	zsuiau	zsu
醒	hwiaee	hwi
妻	qmeaee	qme
透	vnueiu	vnue
购	rfuaao	rfu
替	vkeeuo	vk
塞	blooae	bloo
努	xwauea	xwa
休	hjeiuo	hje
虎	wsuaaa	wsu
扬	kgauuu	kga
途	vnuoee	vnuo
侵	qjaeeo	qja
刑	hmeeui	hme
绿	lcaeei	lca
兄	hiuaaa	hiuaa
迅	hnaeio	hna
套	vieiee	vie
贸	tfuaoa	tfu
毕	nseiii	nse
唯	siuioe	siu
谷	riuouo	riuo
轮	lkuoua	lku
库	cbeaei	cbe
迹	jnoeui	jno
尤	kvoooo	kvoo
竞	jniaeu	jni
街	jteiee	jte
促	pjiaei	pji
延	knuiea	knui
震	gqeuee	gqe
弃	qfaoeu	qfa
甲	jkiiii	jkii
伟	sjeeai	sje
麻	tboooo	tb
川	zuiiii	zui
申	fkiiii	fki
缓	wcuoou	wcu
潜	qoeeuo	qoe
闪	ftuooo	ftu
售	feiaee	feia
灯	dyeiii	dye
针	gaeiii	gaei
哲	gieieu	gie
络	lcuaoi	lcu
抵	dguaea	dgu
朱	gueeiu	gue
埃	plaoue	pla
抱	nguaae	ngu
鼓	rliaeo	rlia
植	gdeiia	gdei
纯	zceaia	zce
夏	hleuia	hleu
忍	swauoo	swa
页	kzoooo	kzo
杰	jdoooo	jdo
筑	gueieu	guei
折	gguuei	gguue
郑	gxouee	gxo
贝	nfoooo	nfo
尊	ccouei	cco
吴	sieeuo	sieeu
秀	hhauuu	hha
混	woiaee	woi
臣	zhiaei	zhi
雅	keeaiu	kee
振	ggeuee	ggeu
染	sdooeu	sdo
盛	fseuaa	fse
怒	xwauea	xwau
舞	sueeii	suee
圆	khiaei	khia
搞	rgoeia	rgo
狂	ckeeie	ckee
措	pgeiie	pge
姓	hmueei	hmu
残	ppeeau	ppe
秋	qhouuo	qho
培	yloeou	yl
迷	tnouei	tnou
诚	zfeuaa	zfe
宽	cpeiii	cpei
宇	kpeeii	kpe
猛	tkaiei	tka
摆	ngiaii	ngi
梅	tdueaa	tdu
毁	whuiea	whu
伸	fjiaee	fji
摩	tgoeue	tg
盟	tsiaee	tsi
末	tveiuo	tve
乃	xauuuu	xa
悲	nwieee	nwi
拍	yguiae	ygu
丁	deiiii	dei
赵	guuooo	guu
硬	kteiae	kte
麦	tceeie	tc
蒋	jvoeiu	jvo
操	pgiaei	pgi
耶	kxaiii	kxa
阻	cxiaee	cxi
订	dfeiii	dfei
彩	pguoou	pgu
抽	zgiaei	zgi
赞	cfueie	cfu
魔	tloeue	tlo
纷	mcuoau	mcu
沿	kouaia	koua
喊	wieuei	wieu
违	sneeai	sn
妹	tmeeiu	tme
浪	looaee	loo
汇	woeaaa	woea
币	nzuiai	nzu
丰	mveeii	mve
蓝	lviiue	lvi
殊	fpueei	fpu
献	hkeiia	hke
桌	goiaee	goia
啦	lieieo	lie
瓦	sroooo	sroo
莱	lveoue	lve
援	kguoou	kguo
译	kfaoee	kfao
夺	dieioo	die
汽	qoueea	qou
烧	fyeaue	fye
距	jqeaea	jqea
裁	ppeieo	ppei
偏	yjoaeu	yj
符	muuiei	mu
勇	kwaoia	kwao
触	zviaei	zvi
课	cfiaee	cfia
敬	jyeiiu	jyei
哭	ckiaei	cki
懂	dweiiu	dwe
墙	qleiou	qle
召	gmaeee	gmae
袭	hfoeua	hfo
罚	meoaii	me
侠	hjeoue	hjeo
厅	vceiii	vce
拜	ngeeee	nge
巧	qieaaa	qiea
侧	pjiauo	pjia
韩	wqeiia	wq
冒	tkiaee	tki
债	gjeeie	gjee
曼	tkiaii	tkia
融	seeiae	see
惯	rwaaie	rwaa
享	hfiaea	hfi
戴	dieiei	diei
童	vniaee	vni
犹	kkeuao	kke
乘	zueiie	zue
挂	rgeiee	rge
奖	jioeiu	jio
绍	fcauia	fca
厚	wciaee	wci
纵	ccuouo	ccu
障	gxoeou	gxoe
讯	hfaeii	hfa
涉	foieie	foie
彻	zteaau	zte
刊	cmeeii	cme
丈	geuooo	geu
爆	nyiaee	ny
乌	suaaee	sua
役	ktuaao	ktu
描	tgeiii	tge
洗	houeie	hou
玛	traaee	tr
患	wwiaei	wwi
妙	tmiuou	tmiu
镜	jaoeou	jao
唱	ziiaee	zii
烦	myeuia	my
签	quuoeo	quu
仙	hjiaii	hjia
彼	ntauia	nta
弗	mhuiii	mhu
症	gbeiei	gbe
仿	mjoeau	mjo
倾	qjeaeu	qje
牌	ycuiae	ycu
陷	hxuaui	hxua
鸟	xneeee	xn
轰	wkaoao	wka
咱	ciuiae	ciu
菜	pvuoou	pvu
闭	nteiuu	nte
奋	miiaei	mii
庆	qbeuoo	qb
撤	zgoeao	zgo
泪	loiaee	loi
茶	zvuoei	zvu
疾	jbueeu	jbu
缘	kcaaeu	kca
播	nguoue	nguo
朗	lsoaee	lsoa
杜	ddeiee	dde
奶	xmauuu	xma
季	jhaiee	jhai
丹	dhoeee	dhoe
狗	rkuaia	rku
尾	squeea	squ
仪	kjouoo	kjou
偷	vjuoei	vju
奔	nieieu	nie
珠	grueei	gru
虫	zeoooo	ze
驻	gpoeei	gpo
孔	chaaaa	cha
宜	kpiaee	kpi
艾	pvuooo	pvuo
桥	qdueuo	qdue
淡	doouuo	doo
翼	kziaei	kzi
恨	wwaeea	wwa
繁	mcueaa	mcue
寒	wpeeii	wpe
伴	njouee	njo
叹	viaooo	via
旦	dkeeee	dke
愈	kwuoei	kwu
潮	zoeiia	zoe
粮	lmoaee	lmoa
缩	bcooau	bco
罢	neeiea	nee
聚	jxaoui	jxa
径	jtaoei	jta
恰	qwuoei	qwu
挑	vguoea	vguo
袋	dpuiea	dpu
灰	wyeuou	wye
捕	ngeiae	ngei
徐	htuoee	htu
珍	gruouu	gruo
幕	tzeiii	tz
映	kkiaeu	kki
裂	lpeuao	lpe
泰	voeeeu	vo
隔	rxeiae	rxe
启	qbiaee	qbi
尖	jseuoo	jseu
忠	gwiaei	gwi
累	lbaaoi	lbaa
炎	kyouuo	kyo
暂	ckeaie	ckea
估	rjeiia	rjei
泛	mouoao	mou
荒	wvoeau	wvo
偿	zjiouo	zji
横	wdeiie	wde
拒	jgeaea	jgea
瑞	sriaie	sri
忆	kwaaaa	kwaa
孤	rhuuao	rhu
鼻	nxiiii	nxi
闹	xtoeia	xt
羊	ksiiii	ksi
呆	dieiuo	dieiu
厉	lceauu	lcea
衡	wtuaia	wtu
胞	nsuaae	nsu
零	lquooa	lqu
穷	qsauuu	qsa
舍	fjeeii	fjee
码	ttaaee	tta
赫	wzeieu	wz
婆	ymooea	ymo
魂	wleeao	wlee
灾	cpouuo	cpo
洪	woeiie	woeii
腿	vsaeea	vsa
胆	dsiaee	dsi
津	joaeee	joa
俗	bjuouo	bj
辩	neoaoe	neo
胸	hsuauo	hsu
晓	hkeaue	hkea
劲	jwaoei	jwa
仁	sjeeee	sjee
贫	yfuoau	yfuo
偶	pjiaee	pjiae
辑	jkiaee	jkia
邦	nxeeeu	nxe
恢	wweuou	wwe
赖	lfeiae	lfe
圈	qhouee	qhou
摸	tgeiii	tgei
仰	kjuaai	kju
润	sooiae	sooi
堆	dluioe	dlu
碰	ytouei	yto
艇	vrueie	vr
稍	fhioui	fhio
迟	znaeuo	zna
辆	lkeiau	lke
废	mbauao	mba
净	jzuaae	jzu
凶	hhuoai	hhu
署	feeieu	fee
壁	nlaeui	nla
御	ktueei	ktue
奉	mveeuo	mvee
旋	hgueai	hgu
冬	dloooo	dloo
矿	ctoeuu	ct
抬	vgaoia	vga
蛋	ddiaei	ddi
晨	zkeuee	zkeu
伏	mjeuoo	mjeu
吹	ziuauo	ziua
鸡	jdaeee	jdae
倍	njoeou	njoe
糊	wmeiia	wme
秦	qheeeu	qhe
盾	dyuuei	dyu
杯	ndeuio	ndeu
租	chiaee	chia
骑	qpeuoe	qp
乏	muoaoo	muo
隆	lxuaoe	lxu
诊	gfuouu	gfuo
奴	xmaooo	xmao
摄	fgeiie	fge
丧	blouea	blou
污	soeeaa	soe
渡	dooeue	dooe
旗	qgueei	qg
甘	rveeee	rve
耐	xceuia	xce
凭	yhuiue	yh
扎	ggaaaa	ggaa
抢	qguoaa	qgu
绪	hceieu	hceie
粗	pmiaee	pmi
肩	jbiaee	jbi
梁	ldooea	ldoo
幻	waoaaa	wa
菲	mvieee	mvi
皆	jsuiae	jsui
碎	btoeuo	bt
宙	gpiaei	gpi
叔	fdieei	fdi
岩	kqeuia	kqe
荡	dvooea	dvo
综	ccooae	ccoo
爬	yjaiea	yja
荷	wvuiei	wvui
悉	hwuoue	hwuo
蒂	dvoeou	dvoe
返	mnuuao	mn
井	jvuiii	jvu
壮	gseiee	gsei
薄	nvooee	nvo
悄	qwioui	qwi
扫	bgaeee	bga
敏	tyueaa	tyu
碍	ptiaee	pt
殖	gpeiia	gpe
详	hfouee	hfou
迪	dniaei	dnia
矛	tauuuu	tau
霍	wquioe	wqu
允	kluaaa	klu
幅	mzeiae	mze
撒	bgeiie	bge
剩	fmueii	fmu
凯	chiaia	chiai
颗	cziaee	czi
骂	tpiaei	tpi
赏	ffiouo	ffio
液	kooeui	kooe
番	mbuoue	mbuo
箱	hueiuo	hue
贴	vfieia	vfi
漫	toiaee	toi
酸	bwaouo	bw
郎	lxoaee	lxo
腰	kseiai	ksei
舒	fjeeii	fjeei
眉	tyaieu	tya
忧	kweuao	kweu
浮	mouoou	mouo
辛	heiiii	hei
恋	lwoeii	lwo
餐	pbieua	pbi
吓	hieioo	hiei
挺	vgueie	vguei
励	lweuea	lweu
辞	puoeou	puo
艘	bruiea	br
键	jaaeee	jaa
伍	sjeiae	sjei
峰	mquaoe	mq
尺	zqoooo	zq
昨	ckueie	cku
黎	loueiu	loue
辈	nkieee	nki
贯	rniauo	rni
侦	gjieia	gji
滑	woiaao	woia
券	qmouee	qmo
崇	zqooae	zqo
扰	sgeuao	sge
宪	hpueie	hpu
绕	sceaue	sce
趋	quuaae	quua
慈	pwouea	pwo
乔	queuou	queu
阅	ktouia	kto
汗	woeeii	woee
枝	gdeiao	gdeia
拖	vgueai	vguea
墨	tleiee	tlei
胁	hsauoo	hsa
插	zgueiu	zgu
箭	juouei	juou
腊	lseiie	lse
泥	xoaeuu	xo
粉	mmuoau	mmu
氏	fuaeaa	fuae
彭	ygeiei	yge
拔	ngeuao	ngeu
骗	ypoaeu	yp
凤	mhaooo	mha
慧	wweeei	wwee
媒	tmeiie	tmei
佩	yjuaei	yju
愤	mweiei	mwe
扑	ygiooo	ygio
龄	luuooa	luu
驱	qpeuoa	qpe
惜	hweiie	hwei
掩	kgeuoi	kgeu
豪	wfiaeo	wfia
兼	jreaee	jrea
跃	kqueuo	kqu
尸	fquuuu	fqu
肃	bruiuo	bru
帕	yzuiae	yz
驶	fpiaeu	fpia
堡	nluiia	nlu
届	jqiaei	jqi
欣	hluauo	hlu
惠	wweiae	wwei
册	peuaua	peu
储	zjoaei	zjo
飘	yxeiai	yx
桑	bdaoao	bda
闲	hteiuo	hte
惨	pwaoeu	pwa
洁	joeiei	joeie
踪	cqooae	cqo
勃	nweioa	nwe
宾	npuiei	npu
频	yzieie	yzi
仇	zjuaaa	zju
磨	ttoeue	tto
递	dnouae	dno
邪	hxeaiu	hxe
撞	ggoeou	ggo
拟	xgaouo	xg
滚	rooeuo	roo
奏	cveeuo	cvee
巡	hnaaao	hnaa
颜	kzoeou	kzoe
剂	jmoeuo	jmo
绩	jceeie	jcee
贡	riiauo	rii
疯	mbuauo	mbua
坡	ylauia	yla
瞧	qyuioe	qyu
截	jeeieu	jee
燃	syuaoo	syu
焦	jeoooo	jeo
殿	dhaeue	dha
伪	sjouao	sjou
柳	lduaua	ldu
锁	baioui	ba
逼	nneiae	nne
颇	yveuia	yve
昏	wkuaea	wku
劝	qdauuu	qda
呈	zieeie	zie
搜	bguiea	bgu
勤	qweiie	qwe
戒	jieeui	jie
驾	jpauia	jpa
漂	yoeiai	yoe
饮	kbuauo	kbua
曹	pkeiae	pke
朵	dhuooo	dhuo
仔	cjaiee	cja
柔	sdaoai	sda
俩	ljeiau	ljei
孟	thiaii	thi
腐	mbuiei	mbui
幼	kwaaoa	kwaao
践	jqeeau	jqee
籍	jueeei	jue
牧	txueuo	tx
凉	lzoeia	lzo
牲	fxueei	fxu
佳	jjeiee	jjei
娜	xmaeeu	xmae
浓	xooaua	xoo
芳	mvoeau	mvoe
稿	rhoeia	rho
竹	guiiii	gui
腹	msueia	msu
跌	dqueeu	dqu
逻	lniaii	lni
垂	zvueie	zvue
遵	cnouei	cno
脉	tsoaau	tso
貌	tjuiae	tju
柏	nduiae	ndui
狱	kkoaeu	kko
猜	pkeeie	pkee
怜	lwuooa	lwu
惑	wweiae	wweia
陶	vxuaue	vxu
兽	friaei	fri
帐	gzueao	gzu
饰	fbueia	fbu
贷	dfuiea	dfu
昌	zkiaee	zki
叙	hduoee	hduo
躺	vcioui	vci
钢	raiauo	ra
沟	rouaao	rou
寄	jpeuoe	jpeu
扶	mgeeuo	mge
铺	yaeiae	ya
邓	ddaiii	dda
寿	fceeeu	fcee
惧	jwiaee	jwi
询	hfuaia	hfua
汤	voauuu	voa
盗	dsoeua	dso
肥	msaiea	msa
尝	zseeao	zsee
匆	ptuuoo	ptu
辉	wseuao	wse
奈	xieeiu	xie
扣	cgiaee	cgi
廷	vnueie	vnuei
澳	pouiao	pou
嘛	tioeue	tio
董	dvueia	dvu
迁	qnueio	qnu
凝	xzuaui	xz
慰	swaeue	swae
厌	kceuoo	kceu
脏	csoeue	cso
腾	vsouee	vsou
幽	kiaaoa	kia
怨	kwuaoa	kwua
鞋	hkeiee	hkei
丢	dlueie	dlue
埋	tliaee	tli
泉	qkiauo	qkia
涌	koaoia	koa
辖	hkooae	hko
躲	dcuaei	dc
晋	jkeiio	jke
紫	ccieie	cci
艰	jdaeea	jdaee
魏	slueiu	slu
吾	sieiae	siei
慌	wweiio	wweii
祝	ghiaeu	ghi
邮	kxiaei	kxia
吐	vieiee	viei
狠	wkaeea	wkae
鉴	jaiiue	jai
曰	kkiaee	kkia
械	hdeeui	hdee
咬	kioeuo	kio
邻	lxuooa	lxuo
赤	zzoooo	zzo
挤	jgoeuo	jgoe
弯	shoeii	shoe
椅	kdeuoe	kdeu
陪	yxoeou	yxo
割	rmooae	rmo
揭	jgiaee	jgi
韦	sqiiii	sqi
悟	sweiae	swe
聪	pxouia	pxo
雾	squaoa	squa
锋	mauaoe	mau
梯	vdouae	vd
猫	tkeiii	tke
祥	hhouee	hho
阔	ctooeu	cto
誉	kfooue	kfoo
筹	zueeeu	zuee
丛	peuouo	peuo
牵	qioaue	qio
鸣	tiuaoa	tiu
沈	fooaua	fooau
阁	rtuaoi	rtu
穆	thuiae	thu
屈	qqaiia	qqa
旨	gkuaia	gkua
袖	hpiaei	hpi
猎	lkeiie	lkei
臂	nsaeui	nsa
蛇	feooau	feo
贺	wfauia	wfa
柱	gdoeei	gdo
抛	yguaau	ygua
鼠	fraaaa	fra
瑟	breeie	bre
戈	rioooo	rio
牢	lpueei	lpu
逊	hnaiei	hnai
迈	tneauo	tne
欺	qkeeuo	qke
吨	dieaia	diea
琴	qreeie	qree
衰	ffaeeu	ffa
瓶	yrouee	yro
恼	xwoeuo	xwo
燕	kyeiie	kye
仲	gjiaei	gjia
诱	kfueiu	kfue
狼	lkoaee	lko
池	zoaiaa	zoa
疼	vbuaoo	vbua
卢	loaeuu	loa
仗	gjeuoo	gjeu
冠	rpeeua	rpe
粒	lmoeou	lmoe
遥	knuoou	knuo
吕	liiaee	liia
玄	hfaaoo	hfaa
尘	zseiee	zsei
冯	mzaaee	mza
抚	mgeeua	mgee
浅	qoeeau	qoee
敦	dyoeia	dyo
纠	jciiii	jcii
钻	caieia	ca
晶	jkiaee	jkiae
岂	qqaeaa	qqae
峡	hqeoue	hqe
喷	yieiei	yie
苍	pvuoaa	pvuoa
凌	lzeieu	lze
耗	wxueea	wx
敲	qkoeia	qko
菌	jviaue	jvia
赔	yfoeou	yfo
涂	vouoee	vou
粹	pmoeuo	pmo
扁	nbiaei	nbi
亏	cvaaaa	cva
寂	jpieei	jpi
煤	tyeiie	tyei
熊	hyaoia	hya
恭	rweiie	rwei
湿	foiaee	foia
循	htuuei	htuu
暖	xkuoou	xk
糖	vmoeua	vmo
赋	mfeeie	mfe
抑	kguaai	kguaa
秩	ghueeu	ghue
帽	tziaee	tzi
哀	pfiaeu	pfi
宿	bpuieu	bpu
踏	vqiauo	vqi
烂	lyouee	lyo
袁	kliaeu	kli
侯	wjaeue	wja
抖	dgooei	dgo
夹	jeoueu	jeou
昆	ckeaua	ckeau
肝	rseeii	rse
擦	pgooau	pgo
猪	gkeieu	gke
炼	lyeaau	lye
恒	wweiae	wweiae
慎	fweiia	fwe
搬	nguuao	nguu
纽	xcaiee	xca
纹	scoeuo	sco
玻	nrauia	nra
渔	kouaia	kouai
磁	ptouea	pto
铜	vaiaei	vai
齿	zuiiii	zuii
跨	cqeuoe	cqe
押	kgiaee	kgia
怖	nweuia	nweu
漠	toeiii	toei
疲	ybauia	yb
叛	yreeuu	yre
遣	qniaei	qni
兹	creaao	cr
祭	jhuaoo	jhu
醉	cwoeuo	cwo
拳	qgouee	qgo
弥	thuaiu	thua
斜	hjuoee	hjuo
档	ddioua	ddio
稀	hhuoeu	hhuo
捷	jgeaee	jgeae
肤	mseeuo	mse
疫	kbuaao	kbuaa
肿	gsiaei	gsi
豆	daeeee	dae
削	hmioui	hmi
岗	rqiauo	rqi
晃	wkioue	wki
吞	vieeuo	viee
宏	wpeuao	wpeu
癌	pbiaei	pbia
肚	dseiee	dse
隶	lroeuo	lroe
履	lquuiu	lquu
涨	goaeau	goae
耀	ksaoea	ksao
扭	xgaiee	xga
坛	vleeao	vlee
拨	ngauao	ngau
沃	soueuo	sou
绘	wcuoee	wcuo
伐	mjeauo	mjea
堪	cleiie	cle
仆	yjiooo	yji
郭	rxoeia	rxo
牺	hxeiau	hxei
歼	jpueii	jpu
墓	tleiii	tleii
雇	rbuioe	rbu
廉	lbouea	lbo
契	qieeei	qiee
拼	ygouee	ygo
惩	zwuuie	zw
捉	ggiaei	ggia
覆	mwuuiu	mwu
刷	fmaeui	fma
劫	jweiea	jwe
嫌	hmouea	hmo
瓜	rjoooo	rjo
歇	hbiaee	hbi
雕	deuaei	deu
闷	ttoaoo	ttoa
乳	sjaiea	sjai
串	ziiaei	ziia
娃	smeiee	smei
缴	jcuiae	jcui
唤	wiuaia	wiua
赢	kfoeai	kfoe
莲	lveaei	lvea
桃	vduoea	vdu
霸	nqeiie	nq
妥	vjauee	vja
瘦	fbuiea	fbui
搭	dgeiiu	dge
赴	muiooo	mui
岳	kquiei	kqui
嘉	jliaeo	jliae
舱	pruoaa	pru
俊	jjaouo	jjao
址	glieie	glie
庞	ybeuau	ybe
耕	rxeeui	rxee
锐	saouia	sa
缝	mcuaoe	mcua
悔	wwueaa	wwue
邀	knuiae	knuia
玲	lruooa	lru
惟	swuioe	swu
宅	gpueaa	gpu
斥	zloooo	zlo
添	voeeuo	voe
挖	sgooau	sgo
呵	wieiae	wiei
讼	bfuoao	bfu
氧	kcouee	kco
浩	woueie	woue
羽	kzeeee	kzee
斤	jliiii	jlii
酷	cwueie	cwue
掠	lgoeia	lgo
妖	kmueuo	km
祸	whiaei	whia
侍	fjeiee	fjei
乙	kaaaaa	kaaa
妨	mmoeau	mmo
贪	vfuooa	vfu
挣	gguaae	ggua
汪	soeeie	soee
尿	xqiauo	xqi
莉	lvueiu	lvu
悬	hwiaee	hwia
唇	zhiaee	zhia
翰	wliaee	wli
仓	pjaaaa	pja
轨	rkuaaa	rkua
枚	tdueuo	tdue
盐	kseiei	kseie
览	lgiiue	lgi
傅	mjeiae	mjei
帅	fziuia	fzi
庙	tbiaei	tbi
芬	mvuoau	mvu
屏	yqouee	yqo
寺	bleioo	ble
胖	ysouee	yso
璃	lroeuo	lroeu
愚	kwiaee	kwi
滴	dooeou	dooeo
疏	fdoeao	fdo
萧	hvaeei	hva
姿	cmoeua	cmo
颤	zzoeia	zzoe
丑	zaieee	zai
劣	lsuauu	lsuau
柯	cdeiae	cde
寸	pcoooo	pc
扔	sgauuu	sga
盯	dyeiii	dyei
辱	sheioo	shei
匹	yhuaaa	yhu
俱	jjiaee	jji
辨	neouoe	neou
饿	pbueie	pbu
蜂	meuaoe	meu
哦	piueie	piue
腔	qsooau	qso
郁	kxeuia	kxe
溃	coiaei	coi
糟	cmeiae	cmei
谨	jfiiei	jfii
葛	rviaee	rvi
苗	tviaei	tvia
肠	zsauuu	zsa
忌	jroaoo	jro
溜	louaoa	loua
鸿	woeieu	woeie
爵	jjiaii	jjia
鹏	ynuaee	ynu
鹰	kbuiui	kbui
笼	lueuau	lue
丘	quieie	qui
桂	rdeiee	rde
滋	coouea	coo
聊	lxuaua	lxua
挡	dgioua	dgio
纲	rciauo	rci
肌	jsuaaa	jsua
茨	pvoeua	pvo
壳	cloaua	cloa
痕	wbaeea	wba
碗	stooau	stoo
穴	hsoooo	hsoo
膀	nseoeo	nseo
卓	goiaee	goiae
贤	hfiiao	hfii
卧	soeiae	soei
膜	tseiii	tse
毅	khoeou	kho
欠	qboooo	qbo
锦	jauiae	jau
哩	liiaee	liiae
函	whaioe	wha
茫	tvooeo	tvo
昂	pkuaai	pku
薛	hvuiae	hvu
皱	gvuaae	gvu
夸	cieeaa	ciee
豫	kaaoai	kaao
胃	sbiaee	sb
舌	fueeee	fue
剥	nmaeei	nma
傲	pjeeie	pjee
拾	fguoei	fguoe
窝	ssiaei	ssi
睁	gyuaae	gyua
携	hguioe	hgui
陵	lxeieu	lxei
哼	wioeia	wio
棉	tduiae	tdui
晴	qkeeie	qkee
铃	lauooa	lau
填	vleiia	vleii
饲	bbaaei	bba
吻	siuauu	siua
渴	coiaee	coia
扮	nguoau	nguoa
逆	xnouea	xno
脆	psuaeu	psu
喘	ziiaie	ziiai
罩	geieia	gei
卜	nooooo	noo
炉	lyoaeu	lyoa
柴	zdieie	zdi
愉	kwuoei	kwuo
绳	fciaei	fci
胎	vsaoia	vsao
蓄	hvoeaa	hvo
眠	tyaeae	tyae
竭	jniaee	jnia
喂	siiaei	sii
傻	fjuiau	fjui
慕	tweiii	twe
浑	wooaea	woo
奸	jmeeii	jme
扇	fbaoea	fba
柜	rdeaea	rdea
悦	kwouia	kwo
拦	lgouee	lgou
诞	dfuiea	dfui
饱	nbuaae	nbu
乾	qliaee	qli
泡	youaae	you
贼	cfeeua	cfee
亭	vfiaeo	vfia
夕	hhoooo	hhoo
爹	dwuaou	dwu
酬	zwouoi	zwo
儒	sjeoai	sjeo
姻	kmiaeu	kmi
卵	luaoua	lua
氛	mcuoau	mcuo
泄	hoeiie	hoe
杆	rdeeii	rdee
挨	pgaoue	pga
僧	bjouia	bjo
蜜	teooao	teo
吟	kiuooa	kiu
猩	hkiaee	hki
遂	bnoueu	bnou
狭	hkeoue	hkeo
肖	hsiaee	hsia
甜	vueiie	vu
霞	hqaeie	hqae
驳	npuouo	npuo
裕	kpuouo	kpu
顽	szeeua	sz
於	kguooo	kguoo
摘	ggoeou	ggoe
矮	paueiu	pau
秒	thiuou	thiu
卿	qxuaua	qxu
畜	zboeaa	zbo
咽	kiiaeu	kiia
披	ygauia	yga
辅	mkeiae	mke
勾	rtaooo	rta
盆	ysuoau	ysu
疆	jheiee	jhei
赌	dfeieu	dfeie
塑	blouea	bloue
畏	sbeauo	sbe
吵	ziiuou	ziiu
囊	xeoaia	xe
嗯	piiaeu	pii
泊	youiae	youi
肺	mseiai	msei
骤	gpeeii	gpee
缠	zcoeui	zco
冈	rhuooo	rhuo
羞	hsaiee	hsai
瞪	dyaouu	dya
吊	diiaii	dii
漏	loaeue	loae
贾	jwieia	jwie
斑	nroeuo	nroe
涛	voeeeu	voee
悠	kwuiiu	kwui
鹿	lhaaaa	lhaa
俘	mjuoou	mjuo
锡	haiaee	hai
卑	nluiae	nlui
葬	cveuao	cveu
铭	tauaoi	taua
滩	voaoui	voao
嫁	jmooae	jmoo
催	pjiaiu	pjiai
璇	hroeau	hro
翅	zzeiao	zze
盒	wjeiae	wjeia
蛮	teoeii	teoe
矣	klueeu	klue
潘	yououe	youo
歧	qdeiao	qde
赐	pfiaee	pfia
锅	raiaei	rai
鲍	nzuaae	nzua
廊	lboaee	lboa
拆	zguuei	zguu
灌	roeiii	roe
勉	twuaia	twu
盲	tyoeai	tyo
宰	cpoeou	cpoe
佐	cjeuei	cjeu
啥	fiuoee	fiuo
胀	gsueao	gsu
扯	zgieie	zgie
禧	hheiei	hhe
辽	lnaioa	lna
抹	tgeeiu	tgee
筒	vuiaei	vui
棋	qdeiie	qdei
裤	cpoeue	cpoeu
唉	piaoue	pia
朴	ydiooo	yd
咐	miuiei	miu
孕	khauai	kha
誓	ffeieu	ffeie
喉	wiuiae	wiui
妄	smoeaa	smo
拘	jguaia	jgua
链	laeaei	lae
驰	zpaiaa	zpai
栏	ldouee	ldou
逝	fneieu	fnei
窃	qseaau	qse
艳	kveeiu	kve
纤	hcueii	hcu
臭	zoeuoo	zoeu
玑	jruaaa	jru
棵	cdiaee	cdia
趁	zuuouu	zuu
匠	jhuuei	jhuu
盈	ksauao	ksau
翁	szuoao	szu
愁	zwueiu	zwu
瞬	fyuoou	fyuo
婴	kmiauo	kmia
孝	hluaie	hlua
颈	jzaoei	jza
倘	vjioui	vji
浙	goeieu	goe
谅	lfoeia	lfoe
蔽	nvouia	nvou
畅	zkauuu	zka
赠	cfouia	cfo
妮	xmaeuu	xmaeu
莎	fvooei	fvo
尉	scaeue	sca
冻	dzeaiu	dzea
跪	rquaeu	rqu
闯	ztaaee	zta
葡	yvuaei	yvu
後	wtaaou	wta
厨	zceiae	zcei
鸭	kniaee	kniae
颠	dzeiia	dzeii
遮	gnoeue	gno
谊	kfooai	kfooa
圳	gluiii	glu
吁	kieeii	kiee
仑	ljuaaa	ljua
辟	yeaeui	yea
瘤	lbuaoa	lbua
嫂	bmuiea	bmu
陀	vxooau	vxo
框	cdeeei	cdee
谭	vfeiai	vfei
亨	wfiaea	wfiae
钦	qauauo	qau
庸	kbaeei	kba
歉	qbouea	qbou
芝	gvoaoo	gvo
吼	wiaiea	wia
甫	meiaee	mei
衫	fpuuuu	fpuu
宴	kpiaee	kpia
摊	vgaoui	vgao
嘱	giaeuu	gia
衷	gfaeiu	gfa
娇	jmueuo	jmue
陕	fxeoue	fxe
浦	yoeiae	yoei
矩	jaeaea	jae
讶	kfeaiu	kfea
耸	bxuouo	bxu
裸	lpiaee	lpi
碧	nteeie	ntee
摧	pgiaiu	pgia
薪	hvoeou	hvoe
淋	loeiuo	loe
耻	zxieie	zxi
胶	jsoeuo	jso
屠	vqieui	vqie
鹅	pnueie	pn
盼	yyuoau	yyu
饥	jbuaaa	jbua
脖	nseioa	nsei
虹	weeiee	wee
翠	pzoeuo	pzo
崩	nquaee	nqu
账	gfueao	gfue
萍	yvooee	yvo
逢	mnuaoe	mnu
赚	gfouea	gfo
撑	zgiouo	zgio
翔	hsaoea	hsao
倡	zjiaee	zjia
绵	tcuiae	tcu
枯	cdeiia	cdei
猴	wkuiae	wkui
巫	seiuou	sei
昭	gkauia	gka
怔	gweiei	gwe
渊	kououe	kouo
凑	pzeeeu	pze
溪	houoou	houo
蠢	zeeeeu	zee
禅	zhouia	zho
阐	ztouia	zto
旺	skeeie	ske
寓	kpiaee	kpiae
藤	vvuaee	vvu
伞	bjouei	bjou
匪	mhieee	mhi
碑	ntuiae	ntu
挪	xgaeeu	xgae
琼	qroeia	qro
脂	gsuaia	gsua
谎	wfeiio	wfe
慨	cwaeea	cwae
菩	yvoeou	yvoe
萄	vvuaue	vvua
狮	fkiuei	fkiu
掘	jgaeua	jgae
抄	zgiuou	zgiu
岭	lquooa	lquo
晕	kkoaea	kkoa
砍	ctuauo	ctu
逮	dnaeei	dna
掏	vguaue	vguau
狄	dkouuo	dko
晰	hkeiuo	hkeiu
罕	wpuoee	wpu
挽	sguaia	sgu
脾	ysuiae	ysui
舟	groooo	gro
痴	zbueeu	zbu
蔡	pvuaoo	pvua
剪	jmouei	jmou
脊	jsoeuo	jsoe
弓	rhaaaa	rha
懒	lweiae	lwei
叉	zdoooo	zdo
喃	xieiia	xiei
拐	rgiaea	rgi
僚	ljeuoo	ljeu
捐	jgiaei	jgia
姊	cmuaiu	cmu
骚	bpaooi	bpa
拓	vgeuia	vge
歪	sdeuio	sdeu
粘	gmieia	gmi
柄	ndeiau	ndei
坑	cloeua	cloe
陌	txeuia	txe
窄	gsueie	gsue
湘	hoeiuo	hoei
兆	guoeau	guo
崖	kqeuei	kqeu
骄	jpueuo	jpue
刹	fmuoei	fmuo
鞭	nkuiei	nku
芒	tvoeaa	tvoe
筋	juuaee	juu
聘	yxiaei	yxi
棍	rdiaee	rdia
钩	rauaao	rau
嚷	sioeia	sio
腺	hsuiae	hsui
弦	hhoeaa	hhoe
焰	kyuaui	kyu
耍	fmeuia	fme
俯	mjoeuu	mjoe
厘	lciaee	lci
愣	lwiaii	lwi
厦	fceuia	fceu
恳	cwaeea	cwaee
饶	sbeaue	sbea
钉	daeiii	daei
寡	rpeuia	rpeu
憾	wweuei	wweu
摔	fgoeaa	fgo
叠	ddaoao	ddao
惹	sweiie	swei
喻	kiuoei	kiuo
谱	yfouei	yfou
愧	cwuiae	cwui
煌	wyuiae	wyu
徽	wtiaie	wti
溶	soooau	sooo
坠	glaiuo	glai
煞	fyuaae	fyua
巾	jziiii	jzi
滥	loiiue	loii
洒	boeiau	bo
堵	dleieu	dle
瓷	proeua	pro
咒	ghiaei	ghia
姨	kmeaea	kme
棒	ndeeeu	ndee
郡	jxaeeu	jxae
浴	kououo	kouou
媚	tmaieu	tmai
稣	bzueiu	bz
淮	wouioe	woui
哎	pieiiu	pie
屁	yqeaua	yqe
漆	qoeiuo	qoei
淫	kouoou	kouoo
巢	zbiaee	zbi
吩	miuoau	miuo
撰	ggaeaa	ggae
啸	hiaeei	hia
滞	goeiii	goei
玫	trueuo	tru
硕	fteuia	fte
钓	dauaoo	dau
蝶	deeiie	dee
膝	hseiuo	hsei
姚	kmuoea	kmu
茂	tveuau	tveu
躯	qceuoa	qce
吏	leiaeu	leiae
猿	kkeiei	kkei
寨	gdooae	gdoo
恕	fwauei	fwa
渠	qdooee	qdo
戚	qieuie	qieu
辰	zhoooo	zhoo
舶	nruiae	nrui
颁	nzuoau	nzuo
惶	wwuiae	wwui
狐	wkuuao	wkuu
讽	mfuauo	mfu
笨	nueiuo	nue
袍	ypuaae	ypu
嘲	zieiia	ziei
啡	miieee	miie
泼	yoauao	yoa
衔	htueee	htue
倦	jjouee	jjou
涵	woaioe	woai
雀	qsuioe	qsu
旬	htiaee	hti
僵	jjeiae	jjeia
撕	bgeiie	bgei
肢	gseiao	gseia
垄	lfeiee	lfei
夷	keauoo	keau
逸	knuaia	knua
茅	tvaoai	tva
侨	qjueuo	qju
舆	kruiee	kru
窑	ksueei	ksu
涅	xoiaee	xoi
蒲	yvooee	yvoo
谦	qfouea	qfo
杭	wdoeua	wdoe
噢	piuiao	piui
弊	nvouia	nvoui
勋	hwiaei	hwiae
刮	ruiiae	rui
郊	jxoeuo	jxo
凄	qzeaee	qz
捧	ygeeeu	ygee
浸	joaeeo	joae
砖	gteeao	gte
鼎	dyaeui	dyae
篮	luiiue	lui
蒸	gvaiau	gva
亩	tfiaei	tfi
饼	nbouee	nbo
肾	fsiiao	fsii
陡	dxeiei	dxe
爪	gjoooo	gjo
兔	vmiaeu	vmi
殷	khuuae	khuu
贞	goiauo	goiau
哑	kieiio	kieii
荐	jveuia	jveu
炭	vqeuou	vqe
坟	mloeuo	mlo
眨	gyuoao	gyuo
搏	ngeiae	ngeia
咳	wioeau	wioe
拢	lgeuau	lge
舅	jkiaei	jkiaei
昧	tkeeiu	tkee
擅	fgoeia	fgoe
爽	feuouo	feu
咖	ciauia	cia
搁	rgoiau	rgoi
禄	lhaeei	lhae
雌	peieie	peie
哨	fiioui	fii
巩	riuaoo	riua
绢	jciaei	jcia
螺	leiaei	leiaei
裹	rfiaee	rfia
昔	hkeiie	hkeii
轩	hkeeii	hkee
谬	tfaoea	tfa
谍	dfeiie	dfeii
龟	rmiaee	rmi
媳	hmuiae	hmui
姜	jsauee	jsa
瞎	hyooae	hyo
冤	kpuaia	kpua
鸦	kneaiu	knea
蓬	yvuaoe	yvua
巷	hreiie	hrei
琳	lreiuo	lrei
栽	cdeiee	cdeie
沾	goieia	goie
诈	gfueie	gfuei
斋	gfeuia	gfeu
瞒	tyeiie	tyeii
彪	ngieau	ngie
厄	pcaaaa	pca
咨	cioeua	cio
纺	mcoeau	mco
罐	ryiaeu	ryi
桶	vdaoia	vda
壤	sloeia	slo
糕	rmouee	rmou
颂	bzuoao	bzu
膨	yseiei	yse
谐	hfeaua	hfe
垒	llaoao	lla
咕	rieiia	riei
隙	hxiuoi	hxi
辣	leeiae	lee
绑	nceeeu	nce
宠	zpeuau	zpe
嘿	wiiaou	wiiao
兑	driaeu	driae
霉	tqueaa	tqu
挫	pguouo	pguo
稽	jheuao	jheu
辐	mkeiae	mkei
乞	queaaa	quea
纱	fciuou	fciu
裙	qpaeeu	qpa
嘻	hieiei	hieie
哇	sieiee	sieie
绣	hcueiu	hcue
杖	gdeuoo	gdeu
塘	vloeua	vlo
衍	ktooee	ktoo
轴	gkiaei	gki
攀	ygeiuo	ygei
膊	nseiae	nseia
譬	yfaeui	yfa
斌	nfeeie	nfe
祈	qhuuei	qhu
踢	vqiaee	vqia
肆	bsoaee	bs
坎	cluauo	clua
轿	jkueuo	jku
棚	yduaee	ydu
泣	qooeou	qoo
屡	lqeiuo	lqe
躁	cqiaei	cqi
邱	qxuiei	qxui
凰	whuiae	whui
溢	kooueu	kooue
椎	zduioe	zdu
砸	cteiai	cte
趟	vuioui	vuio
帘	lsiaii	lsi
帆	mzuaoo	mzu
栖	qdeiau	qdeia
窜	psiaei	psi
丸	suaooo	suao
斩	gkuuei	gkuu
堤	dliaee	dli
塌	vliaee	vliae
厢	hceiuo	hceiu
贩	mfuuao	mfuu
掀	hguuei	hguu
喀	ciooau	cioo
乖	rueiie	ruei
谜	tfouei	tfo
捏	xgiaee	xgi
阎	ktuaui	ktua
滨	noooau	nooo
虏	lsauuu	lsa
匙	fkeieu	fkei
芦	lvoaeu	lvo
苹	yveoue	yveo
卸	hxueei	hxue
沼	goauia	goau
钥	kauaee	kau
株	gdueei	gdu
祷	dheeeu	dhe
剖	ymoeou	ymoe
熙	hyeiia	hye
劈	ymaeui	yma
哗	wiuiua	wiuiu
怯	qweiea	qwei
棠	vdiouo	vdi
胳	rsuaoi	rsua
桩	gdoeue	gdoe
瑰	rruiae	rru
娱	kmiaee	kmiae
娶	qmeiie	qmei
沫	toeeiu	toee
嗓	biaoao	bia
蹲	dqouei	dqo
淘	vouaue	voua
焚	myeiuo	mye
嫩	xmeiae	xme
韵	kguaoe	kguao
匈	htuoai	htuo
衬	zpeioo	zpei
竖	fniiao	fni
钧	jauaoe	jaua
峻	jqaouo	jqa
豹	njuaoo	njua
捞	lgeiio	lgei
菊	jvuaou	jvua
鄙	nxiaee	nxia
魄	ykuiae	yk
兜	dfuiae	dfuia
哄	wieiie	wieii
颖	kzuaue	kzu
镑	naoeou	nao
屑	hqioui	hqi
蚁	keouoo	keo
壶	wlaiio	wla
怡	kwaoia	kwaoi
渗	foaoeu	foa
秃	vhuaaa	vhua
迦	jnauia	jnau
旱	wkeeii	wke
哟	kiaaeu	kiaa
咸	hieuei	hieu
焉	kyeiei	kyei
宛	spuaoa	spu
谴	qfiaei	qfi
稻	dhuoou	dhuoo
铸	gaeeeu	gaee
伽	rjauia	rja
锻	dauiee	daui
詹	gmeuuo	gme
毙	nseuao	nseu
恍	wwioue	wwio
贬	nfuoao	nfuo
烛	gyiaei	gyia
骇	wpoeau	wpo
芯	hvoaoo	hvoa
汁	goeiii	goeii
桓	wdeiae	wdei
坊	mloeau	mloe
驴	lpoaeu	lpo
朽	hdeaaa	hdea
靖	jneeie	jne
佣	kjuaee	kjua
汝	soauee	soa
碌	ltaeei	lta
迄	qnueao	qnue
冀	jrieeu	jrie
荆	jmeiie	jmei
崔	pquioe	pqu
雁	kcuiui	kcui
绅	fciaee	fcia
珊	fruaua	fru
榜	ndoeou	ndo
诵	bfaoia	bfa
傍	njoeou	njoeo
彦	kfoueu	kfou
醇	zwoeia	zwoe
笛	duiaei	dui
禽	qjoeuo	qjo
勿	stuuuu	stu
娟	jmiaei	jmia
瞄	tyeiii	tyeiii
幢	zzoeou	zzoeo
寇	cpeeua	cpee
睹	dyeieu	dyeie
贿	wfeuia	wfeu
踩	pquoou	pquo
霆	vqueie	vqu
呜	siuaae	siuaa
拱	rgeiie	rgei
妃	mmaeaa	mmae
蔑	tviaii	tviai
谕	kfuoei	kfuo
缚	mceiae	mce
诡	rfuaeu	rfua
淹	koeuoi	koeu
篷	yuuaoe	yuu
腕	ssooau	sso
煮	gyeieu	gyei
倩	qjeeie	qjee
卒	cfuouo	cfuo
勘	cweiie	cwei
馨	hlaieu	hlai
逗	dneiae	dnei
甸	dtiaei	dti
贱	jfeeau	jfeea
炒	zyiuou	zy
灿	pyiaii	py
敞	zyioui	zyi
蜡	leeiie	leei
囚	qhuooo	qhuo
栗	lweiuo	lweiu
辜	rlouee	rlou
垫	dleieu	dlei
妒	dmoaeu	dmo
魁	clooei	cloo
谣	kfuoou	kfuoo
寞	tpeiii	tpe
甩	fsaaaa	fsa
蜀	feuaia	feua
枕	gdoaua	gdoa
涯	koeuei	koeue
丐	reieaa	rei
泳	kooaau	kooa
奎	cieiee	ciei
泌	tooaou	too
逾	knuoei	knuoe
叮	dieiii	dieii
黛	dluiea	dlui
燥	cyiaei	cyi
掷	ggouee	ggou
憎	cwouia	cwou
枢	fdeuoa	fdeu
藉	jveeei	jvee
鲸	jzoeia	jzo
弘	whaooo	whao
倚	kjeuoe	kjeuo
侮	sjueaa	sjue
藩	mvooeu	mvoo
拂	mgaeau	mga
鹤	wnoaui	wno
蚀	fbiaei	fbi
浆	jooeiu	joo
芙	mveeuo	mveeu
垃	lloeou	lloe
烤	cyeieu	cye
晒	fkeiau	fkeia
霜	fqeiuo	fqe
剿	jmaaae	jmaa
蕴	kvaaei	kvaae
圾	jluaoo	jlua
屿	kqeaee	kqea
绸	zcuaei	zcu
氢	qcaoei	qca
驼	vpooau	vpo
妆	gsauee	gsa
捆	cgiaei	cgia
铅	qauaia	qaua
逛	rnuaue	rnu
淑	foieei	foiee
榴	lduaoa	ldua
丙	neiauo	nei
痒	kbouee	kbo
钞	zaiuou	zaiu
蹄	vqoeou	vqo
犬	qkoooo	qkoo
躬	rcaeaa	rca
昼	gqoiae	gqo
藻	cviooe	cvi
蛛	geueei	geue
褐	wpiaee	wpi
颊	jzeoue	jzeo
奠	diouei	dio
募	tweiii	twei
耽	dxoaua	dxo
蹈	dquoou	dquo
陋	lxeiau	lxeia
侣	ljiaei	lji
魅	tleeiu	tlee
岚	lquauo	lqua
侄	gjeaoe	gjea
虐	xseaee	xse
堕	dlaieu	dla
陛	nxeaua	nxea
莹	kreiio	krei
荫	kvaiua	kvai
狡	jkoeuo	jkoeu
阀	mtuiea	mt
绞	jcoeuo	jcoe
垮	cleuoe	cleu
膏	rfiaeo	rfiae
茎	jvaoei	jvao
缅	tceuia	tce
喇	lieiae	liei
绒	sceeua	scee
搅	jgoouo	jgoo
凳	dhaouu	dhao
梭	bdaouo	bdao
丫	kouiii	koui
姬	jmeiia	jmeii
诏	gfauia	gfau
钮	xaaiee	xaa
棺	rdooai	rdo
耿	rxouuo	rxou
缔	dcoeou	dco
懈	hwuaua	hwua
嫉	jmoeuo	jmoe
灶	cyeiee	cyei
匀	ktoeee	ktoe
嗣	biiaei	biia
鸽	rnuoei	rnuo
澡	coiaei	coiae
凿	clouee	clou
纬	sceeai	sceea
沸	moaeau	moa
刃	smoooo	smoo
畴	zbeeeu	zbe
遏	pniaee	pni
烁	fyuaiu	fyuai
嗅	hiuiae	hiui
叭	niuooo	niu
熬	pyeeie	pye
瞥	yyouia	yyo
骸	wwoeau	wwo
奢	fieieu	fie
拙	ggaiia	ggai
栋	ddeaiu	ddea
毯	vuouuo	vuo
桐	vdiaei	vdia
砂	ftiuou	fti
泻	hooaea	hooa
莽	tveuoo	tveuo
坪	yleoue	yle
梳	fdoeao	fdoe
晤	skeiae	skei
杉	fduuuu	fduu
稚	ghuioe	ghui
蔬	fvaiei	fva
蝇	keiaei	kei
捣	dguaoa	dgua
顷	qzeaeu	qze
麽	tbuaoo	tbu
尴	rviiue	rvii
镖	naeiai	nae
尬	rvuoui	rvu
诧	zfooau	zfo
硫	ltoeao	lto
嚼	jiuoou	jiu
羡	hsoeua	hsoe
沦	lououa	louo
沪	wooaeu	wooa
旷	ckoeuu	cko
彬	ndeiuo	ndeiu
芽	kveaiu	kvea
冥	tpiaee	tpia
狸	lkiaee	lki
碳	vtiaie	vti
咧	lieuao	lieu
惕	vwiaee	vwi
暑	fkeieu	fkeie
咯	riuaoi	riuao
萝	lviaii	lvia
汹	houoai	houoa
腥	hsiaee	hsiae
窥	cseeuo	cse
俺	pjeuoi	pjeu
潭	voeiai	voei
崎	qqeuoe	qqe
麟	lhouei	lho
捡	jguoeo	jguo
厥	jcouea	jcou
拯	ggaiau	ggaia
澄	zoaouu	zoao
哉	cieiei	cieie
萎	svueiu	svu
涡	soiaei	soia
滔	vouoou	vouo
暇	hkaeie	hka
溯	boouea	boo
鳞	lzouei	lzou
酿	xwoaee	xwoa
愕	pwiaei	pwia
茵	kviaeu	kvia
暮	tkeiii	tkei
瞅	zyueiu	zyu
衙	kteiae	ktei
诫	jfeeui	jfeeu
斧	mwuuei	mwuu
兮	hreaaa	hrea
焕	wyuaia	wyua
棕	cdooae	cdo
佑	kjeuia	kjeui
嘶	bieiie	bie
妓	jmeiao	jmeia
喧	hiooae	hio
蓉	svooau	svo
删	fmuaua	fmua
樱	kdiauo	kdi
伺	pjaeia	pjae
嗡	siuoao	siuo
娥	pmueie	pmu
梢	fdioui	fdio
坝	nliauo	nli
蚕	peeeuo	pee
敷	myeiae	myei
澜	looiae	looi
杏	hdiaee	hdi
绥	bcuoou	bcu
冶	kzaoia	kza
庇	nbeaua	nbe
挠	xgeaue	xge
搂	lgouei	lgoue
倏	fjiuao	fjiu
婉	smooau	smooa
聂	xxaoao	xxa
噪	ciiaei	ciia
稼	jhooae	jho
鳍	qzeieu	qzei
菱	lveieu	lvei
盏	gseeau	gsee
匿	xheiie	xhe
吱	gieiao	giei
寝	qpaoei	qpao
揽	lgiiue	lgii
髓	bweuei	bwe
秉	nrueae	nrue
哺	nieiae	niei
矢	faoooo	fao
啪	yieieu	yiei
帜	gziaeu	gzi
邵	fxauia	fxa
嗽	bieiae	biei
挟	hgeoue	hgeo
缸	ryeiee	rye
揉	sgaoai	sgao
腻	xseeei	xsee
驯	hpuiii	hpui
缆	lciiue	lcii
晌	fkuiai	fkui
瘫	vbaoui	vbao
贮	gfooae	gfoo
觅	tjiaua	tji
朦	tseiio	tsei
僻	yjaeui	yjae
隋	bxeuei	bxe
蔓	tviaee	tviae
咋	ciueie	ciue
嵌	qqeiie	qqei
虔	qsoeuo	qsoe
畔	ybouee	ybo
琐	brioui	bri
碟	dteiie	dteii
涩	boauoi	boa
胧	lseuau	lseu
嘟	dieieu	dieie
蹦	nqiaiu	nqi
冢	gpeuau	gpeu
浏	looeuo	looe
裔	kpiauo	kpiau
襟	jpeiuo	jpei
叨	diauuu	dia
旭	hkuaia	hkua
诀	jfaeuo	jfae
虾	heeioo	heei
簿	nuooee	nuo
啤	yiuiae	yiu
擒	qguooe	qguo
枣	ceiaiu	ceia
嘎	rieuia	rieu
苑	kvuaoa	kvua
牟	tlueei	tlu
呕	pieuoa	pieu
骆	lpuaoi	lpua
凸	vhieia	vhi
熄	hyuiae	hyu
兀	sfeuaa	sfe
喔	piaeue	piae
裳	fpiouo	fpio
凹	phiaia	phi
赎	ffeiao	ffeia
屯	veaiaa	ve
膛	vsiouo	vsi
浇	joeaue	joeau
灼	gyuaoo	gyuao
裘	qpeioe	qpei
砰	yteoue	yte
棘	jeiaiu	jei
橡	hduaia	hdua
碱	jteuei	jteu
聋	lfeiie	lfeii
姥	lmeieu	lme
瑜	kruoei	kruo
毋	snaaue	sna
娅	kmeiio	kmei
俏	qjioui	qjio
沮	joiaee	joi
萌	tviaee	tviaee
黯	ploeou	plo
撇	ygouia	ygou
粟	bwouei	bwo
尹	kruuuu	kruu
粪	mmeiie	mmei
苟	rvuaia	rvua
癫	dbeiia	dbe
蚂	teaaee	tea
禹	kuiaei	kui
廖	lbaoea	lbao
俭	jjuoeo	jjuo
帖	vzieia	vzi
煎	jyouei	jyo
窦	dseiao	dsei
缕	lcouei	lco
簇	puoeau	puoe
棱	ldeieu	lde
叩	ciaiii	ciai
呐	xiiauo	xii
瑶	kruoou	kruoo
墅	fliaee	fli
莺	kneiio	knei
烫	vyooea	vy
蛙	seeiee	seei
伶	ljuooa	ljuo
歹	dpoooo	dpo
葱	pvuauu	pvuau
哮	hieieu	hieieu
眩	hyoeaa	hyoe
坤	cliaee	clia
廓	cboeia	cbo
讳	wfeeai	wfee
啼	vioeou	vioe
乍	gueiee	gueie
瓣	neuuao	neuu
矫	jaueuo	jaue
枉	sdeeie	sdee
跋	nqeuao	nqe
梗	rdeiae	rdei
厕	pciauo	pci
琢	creuau	cre
讥	jfuaaa	jfua
釉	kuiaei	kuia
窟	csaeua	csa
敛	lyuoeo	lyu
轼	fkeeie	fkee
庐	lboaeu	lboae
胚	yseuio	yseu
呻	fiiaee	fiia
绰	zcieia	zci
扼	pgeuaa	pgeu
懿	kleiae	kleia
炯	jyiaia	jyi
竿	rueeii	ruee
慷	cwoeua	cwoe
虞	ksiaee	ksia
锤	zaueie	zau
栓	fduoee	fduo
桨	jdoeiu	jdoe
蚊	seoeuo	seo
磅	nteoeo	nteo
孽	xvuiae	xv
惭	pweaie	pwe
戳	ziaoea	zia
禀	nfiaia	nfi
鄂	pxiaei	pxi
馈	cbiaei	cbi
垣	kleiae	kleiae
咚	diuaoo	diu
溅	joiauo	joia
礁	jtuioe	jtu
钙	raeiea	rae
彰	ggoeou	ggoeo
眯	tyouei	tyou
豁	wpiaeu	wpia
磷	ltouei	ltou
雯	sqoeuo	sqo
墟	hlieau	hlie
迂	kneeio	knee
瞻	gyuaeu	gyuae
颅	lzieae	lzie
琉	lroeao	lroea
悼	dwieia	dwi
蝴	weeiia	weei
拣	jgeaau	jgeaa
渺	toiaee	toia
眷	jyouee	jyou
悯	twoiao	twoi
汰	voeuoo	voeu
慑	fweiie	fwei
婶	fmooai	fmo
斐	mfieee	mfi
嘘	hiieau	hii
镶	haoeia	hao
炕	cyoeua	cyo
宦	wpeiae	wpei
趴	yquooo	yqu
绷	ncuaee	ncu
窘	jsaeeu	jsae
襄	hfiaei	hfia
珀	yruiae	yru
嚣	hiiaee	hiia
拚	ygaoeu	ygao
酌	gwuaoo	gwu
毓	kueaao	kue
浊	goiaei	goiaei
嗜	fieieu	fiei
撼	wgeuei	wge
扛	cgeiee	cge
峭	qqioui	qqi
磕	cteiea	ctei
翘	qzeaue	qzea
槽	pdeiae	pdeia
栅	fduaua	fdua
淌	voioui	voi
熏	hyueia	hyue
瑛	kreiii	kreii
颓	vzueiu	vzu
忖	pweioo	pwei
颐	kzeiia	kzei
牡	txeiee	txei
缀	gcaoao	gca
徊	wtiaia	wtia
梨	ldueiu	ldue
肪	msoeau	mso
涕	voouae	voo
惫	nliaei	nlia
摹	tgeiii	tgeii
踱	dqoeue	dqoe
肘	gseioo	gseio
挚	ggeieu	ggeie
熔	syooau	syo
氯	lcaeei	lcae
凛	lzoeia	lzoe
绎	kcaoee	kcao
庶	fbeiie	fbe
脯	yseiae	ysei
睦	tyeieu	tyeie
迭	dnueeu	dnu
窍	qseiee	qsei
粥	ghouei	gho
庵	pbeuoi	pbe
沧	pouoaa	pouo
奕	kioeui	kioe
怠	dwaoia	dwa
沁	qooaoo	qooa
咙	lieuau	lieua
氨	pcooaa	pco
矗	zleeii	zlee
盔	cseuou	cseu
拇	tgaaoe	tga
沛	yoeiai	yoeia
榻	vdiaee	vdiae
揣	zgiaie	zgia
崭	gqeaie	gqea
鞘	qkioui	qkio
鞠	jkuaou	jkua
垦	claeea	claee
唾	viueie	viue
洽	qouoei	qouo
橱	zdeuei	zdeu
仕	fjeiee	fjeie
蜘	geueeu	geuee
痰	vbouuo	vbo
袜	speeiu	spe
峙	gqeiee	gqei
柬	jeiaou	jeia
蝉	zeouia	zeo
蟹	heuaua	heu
谏	jfeiao	jfeia
擎	qgeiiu	qge
鹃	jniaei	jniae
皓	wkueie	wkue
朕	gsouee	gso
疤	nbaiea	nba
禺	kkaieo	kka
铲	zaoeou	zao
酶	twueaa	twue
钝	daeaia	daea
匣	hhiaee	hhia
氓	tfaaea	tfaa
弧	whuuao	whuu
峨	pqueie	pque
锥	gauioe	gau
揪	jgueiu	jgue
杠	rdeiee	rdeie
吭	cioeua	cioe
崛	jqaeua	jqae
诬	sfeiuo	sfei
冉	shieee	shi
抒	fgaoai	fga
庚	rbaeeu	rba
悍	wwiaee	wwia
靡	tbieee	tbie
晦	wkueaa	wkuea
醋	pweiie	pweii
壕	wloeia	wloe
夭	kueuoo	kueu
锯	jaaeue	jaae
咦	kieaea	kieae
侈	zjuaou	zjua
婢	nmuiae	nmu
猾	wkiaao	wkia
徘	ytieee	yti
硝	htioui	htio
煽	fyoaeu	fyoa
皂	ckeaaa	ckeaa
嗦	bieioa	bieio
舵	drooau	dro
狈	nkiauo	nkia
靴	hkuiua	hkui
捂	sgeiae	sgei
疮	zbuoaa	zbuo
郝	wzaiii	wza
苛	cveiae	cvei
秽	whiaiu	whiai
茜	qveiau	qv
搓	pgouee	pgou
芸	kveeao	kvee
赁	lfuiue	lfui
酱	jwoeiu	jwoe
檐	kduaeu	kdua
饷	hbuiai	hbu
蕉	jvuioe	jvui
铀	kaiaei	kai
苔	vvaoia	vva
赦	fzueuo	fzue
缎	dcuiee	dcu
舷	hroeaa	hroe
筷	cuooia	cuo
朔	fsouea	fsou
婪	lmeiuo	lmei
紊	sfoaao	sfo
厮	bceiie	bce
婿	hmaieu	hma
寥	lpaoea	lpa
兢	jliaeu	jliaeu
糙	pmueie	pmue
卦	roeiee	roei
槐	wduiae	wdu
扒	nguooo	nguoo
裴	ypieee	ypi
祀	bhaeaa	bhae
埔	yleiae	ylei
絮	hcauei	hca
芭	nvaiea	nva
屉	vqeiie	vqei
痪	wbuaia	wbu
霄	hqioui	hqio
绽	gcooae	gco
宵	hpioui	hpio
邑	kiaiea	kiai
霖	lqeiuo	lqei
岔	zquoau	zqu
茄	jvauia	jvau
饵	pbeiie	pbei
韧	sqauoo	sqa
琪	qreiie	qrei
邹	cxuaae	cxu
瑚	wreiia	wrei
憋	nwouia	nwou
殆	dpaoia	dpa
噜	liuaia	liu
忒	vweoao	vwe
忿	mwuoau	mwuo
衅	hhouee	hhou
淳	zooeia	zoo
悖	nweioa	nwei
髦	tqueea	tque
孜	chueuo	chu
粤	kuiaou	kuiao
隘	pxoueu	pxou
濒	noieie	noi
铮	gauaae	gaua
畸	jbuoei	jbuo
剔	vmiaee	vmia
坞	sluaae	slua
篱	luoeuo	luo
淀	doooae	dooo
蓦	tpeiii	tpei
唬	wiieau	wiie
汀	voeiii	voeii
趾	gqieie	gqi
锣	laiaii	lai
嫦	zmiouo	zmi
缉	jciaee	jciae
斟	gjeiie	gjei
鞍	pkooaa	pko
扳	nguuao	nguua
拴	fguoee	fguoee
诅	cfiaee	cfiae
谟	tfeiii	tfe
呃	pieuaa	pieua
懦	xweoai	xwe
忏	zwueii	zwue
犁	lxueiu	lxue
逞	zniaee	zni
拧	xgooae	xgo
亥	wfauuo	wfau
佟	vjuaoo	vjua
叱	ziuaaa	ziuaa
舜	fjoaua	fjoa
绊	ncouee	ncou
龚	rfeiie	rfe
腮	bsiaei	bsi
邸	dxuaea	dxua
椒	jdieei	jdi
蔚	svaeue	sva
湛	goeiie	goeiie
狩	fkooae	fko
眶	cyeeei	cyee
栈	gdeeau	gdeea
薇	svuuii	svuu
肮	psoeua	pso
瀑	yoiaee	yoi
渣	goeiuo	goeiu
褂	rpeiee	rpei
叽	jiuaaa	jiua
臀	vsaeue	vsae
妞	xmaiee	xmai
巍	squeiu	sque
唔	sieiae	sieia
疚	jbuaoo	jbuao
戎	sieeua	sieeua
鲤	lziaee	lzia
肇	gmoaeu	gmo
笃	duaaee	dua
娴	hmoiae	hmoi
辙	gkoeao	gko
札	gdaaaa	gda
阮	sxeeua	sxee
懊	pwuiao	pwu
焘	dyeeeu	dyee
恤	hwuiai	hwui
疹	gbuouu	gbu
潇	hoeiia	hoeii
铝	laiaei	laia
涤	douaoe	dou
喽	liouei	lio
恃	fweiee	fweie
砌	qteaau	qte
楞	ldiaii	ldi
遁	dnuuei	dnuu
阱	jxeeui	jxe
咎	jiuaoi	jiuao
洼	soeiee	soeie
炳	nyeiau	nye
噬	fiueou	fiue
拷	cgeieu	cgei
枫	mduauo	mdua
哆	diuaou	diua
矶	jtuaaa	jtua
苇	sveeai	svee
翩	yzoaeu	yzo
窒	gseaoe	gsea
侬	xjoaua	xjo
胰	kseaea	ksea
靶	nkaiea	nka
芜	sveeua	sveeu
嚎	wioeia	wioei
妾	qnauee	qna
辫	neaaeo	nea
幌	wziaee	wzi
踉	lqoaee	lqo
佃	djiaei	djia
葫	wveiia	wve
拽	ggiaee	ggiae
皖	skooae	sko
滤	loieau	loie
睬	pyuoou	pyu
俞	kjeiae	kjei
匕	nuaaaa	nua
嗤	ziiaie	ziiaie
谤	nfoeou	nfoe
捍	wgiaee	wgi
孵	mjuaou	mjua
倪	xjuiea	xju
瘾	kbaiua	kbai
匡	cheeie	chee
敝	nyouia	nyo
磋	ptouee	ptou
绫	lceieu	lcei
尧	kfeaue	kfeau
淆	houoeu	houoe
蕊	svoaoo	svoa
烘	wyeiie	wyei
璋	groeou	groe
亢	cfuaaa	cfua
轧	kkaaaa	kkaa
赂	lfuaoi	lfua
榆	kduoei	kduo
蝗	weuiae	weu
诛	gfueei	gfuee
骏	jpaouo	jpao
勺	ftoooo	fto
梵	mdeiuo	mde
炽	zyiaeu	zyia
笠	luoeou	luoe
颌	wzuoei	wzu
闸	gtiaee	gti
狒	mkaeau	mka
樊	mieiuo	miei
垢	rluuei	rlu
瘟	sbiaee	sbi
缪	tcaoea	tca
菇	rvauee	rva
琦	qreuoe	qreu
剃	vmouae	vmou
溺	xoaeao	xoa
炫	hyoeaa	hyoea
迸	nnouee	nnou
惚	wwuauu	wwua
嗨	wiooeu	wioo
陨	kxiaei	kxiae
赃	cfoeue	cfoe
羁	jeeiie	jeei
嘀	dioeou	dioe
臻	geaoei	gea
膳	fsouee	fsoue
赣	rniaee	rnia
殉	hpuaia	hpua
踌	zqeeeu	zqe
桔	jdeiei	jde
瞿	qeiaee	qei
闽	ttiaei	tti
豚	vseuau	vse
掺	pgaoeu	pgao
沌	doeaia	doe
喳	gieiuo	gieiu
惰	dweuei	dweu
椭	vdaieu	vdai
咪	tiouei	tiou
霎	fqoeou	fqo
侃	cjiaeu	cji
猝	pkoeuo	pkoe
戮	liaoea	lia
窖	jsueie	jsue
祠	phaeia	pha
瞩	gyaeuu	gya
菁	jveeie	jveei
佬	ljeieu	ljeie
躇	zqeiie	zqei
咄	diaiia	diai
肋	lsauuu	lsau
忡	zwiaei	zwi
雍	kfaauu	kfaa
忱	zwoaua	zwoa
蕾	lveoai	lveo
跄	qquoaa	qqu
伎	jjeiao	jjeiao
硅	rteiee	rte
炊	zyuauo	zyua
钊	gaiiii	gaii
蝠	meeiae	mee
屎	fqouei	fqou
拭	fgeeie	fgee
谛	dfoeou	dfoe
褪	vpaeea	vpa
丞	zeaiau	zea
卉	wleuii	wleu
隧	bxoueu	bxo
茸	sveiie	svei
钳	qaeiie	qae
伢	kjeaiu	kjea
啃	ciieie	ciie
舔	vueeuo	vue
闺	rteiee	rtei
蹬	dqaouu	dqa
挛	lgoeii	lgoe
眺	vyuoea	vyu
袱	mpuieu	mpu
陇	lxeuau	lxeu
柿	fdoeia	fdoei
殴	pheuoa	phe
梧	sdeiae	sdei
惺	hwiaee	hwiaee
侥	jjeaue	jjea
弛	zhaiaa	zha
琛	zroauo	zro
捅	vgaoia	vgaoi
酝	kweeao	kwee
薯	fviaii	fvi
曳	kkauuu	kkau
澈	zooeao	zooe
锈	haueiu	haue
稠	zhuaei	zhua
眸	tyaoue	tyao
咆	yiuaae	yiua
簧	wueiie	wue
疡	kbauuu	kbau
鸥	pneuoa	pne
渎	doeiao	doei
嬉	hmeiei	hmei
汲	jouaoo	joua
脓	xsoaua	xso
穗	bheiae	bhe
骡	lpiaei	lpia
巳	braeaa	bra
拎	lguooa	lguo
槛	cdiiue	cdii
邢	hxeeui	hxee
廿	xveeee	xve
搀	zguaia	zgua
曙	fkiaii	fkia
樵	qduioe	qdui
隅	kxiaee	kxiaee
筛	fuiuei	fui
谒	kfiaee	kfi
倭	sjueiu	sjuei
痹	nbiaei	nbia
猖	zkiaee	zkia
佯	kjouee	kjoue
奚	hjaaoe	hja
肛	rseiee	rsei
抨	ygeoue	ygeo
甭	nfeuio	nfeu
蛾	peueie	peue
唠	lieiio	lieii
嵩	bqoeia	bqo
荧	kyeiio	kyeii
漱	foeiae	foe
攘	sgoeia	sgoe
诘	jfeiei	jfeie
酋	qreiau	qreia
篡	puiaee	pui
睿	syieoa	syi
噩	peiiae	peii
怅	zwueao	zwuea
徙	htieie	htie
盎	psiaeu	psia
鞅	kkiaeu	kkiae
漓	looeuo	looeu
祟	bhaiia	bhai
攸	kjiueu	kji
睫	jyeaee	jyea
翎	lzuooa	lzuo
呛	qiuoaa	qiu
堑	qleaie	qlea
檀	vdoeia	vdo
筐	cueeei	cue
寅	kpeiae	kpei
惘	swiaou	swi
磊	lteuia	lte
驭	kpoooo	kpoo
吠	mieuoo	mieu
驮	vpeuoo	vpe
瑙	xraaau	xra
炬	jyeaea	jyeae
痉	jbaoei	jba
恺	cwiaia	cwi
曝	ykiaee	yki
敕	zyeiae	zye
胺	psooaa	psoo
萤	keeiio	keei
筝	guuaae	guua
幡	mzuoue	mzuo
竺	gueeee	guee
霹	yqaeui	yqa
毗	ybeaua	ybea
烙	lyuaoi	lyua
鸠	jnuaua	jnua
埠	nluiae	nluia
蒜	bveeiu	bve
阜	mluiae	mlu
嘈	pieiae	piei
乒	yuieie	yui
帷	szuioe	szui
啄	gieuau	gieu
鳌	pzeeie	pzee
毡	guieia	guie
阙	qtouea	qto
褥	speuee	speu
搔	bgaooi	bgao
笋	buaeeu	bua
冕	tkuaia	tku
狞	xkooae	xko
韶	fgauia	fgau
骼	rwuaoi	rwu
蔼	pvoaia	pvoa
烹	yfiaea	yfi
奄	kiiaee	kiiae
嫖	ymeiai	yme
沐	toeiuo	toeiu
噗	yiiiou	yii
岑	pquooa	pquoo
蛟	jeoeuo	jeoe
咏	kioaau	kioa
弩	xhauea	xha
掳	lgieau	lgie
圃	yheiae	yhe
孚	mjaiee	mja
捻	xguooa	xgu
悴	pwoeuo	pwoe
呱	riuuao	riuu
诣	kfuaia	kfua
祁	qhaiii	qha
捶	zgueie	zgue
钠	xaiauo	xai
袄	ppueuo	ppu
澎	yoeiei	yoeie
恪	cwuaoi	cwua
氮	dcouuo	dcou
雏	zeuaae	zeu
堰	kleiae	kleiae
彷	ytoeau	ytoe
撮	pgiaee	pgiae
鹦	kniauo	kniau
晖	wkoaea	wko
犀	hqeuou	hqeu
橄	rdaeii	rdaei
沽	roeiia	roeii
腑	msoeuu	msoe
亵	hfeieu	hfei
掐	qguaui	qgua
龋	quuiae	quui
嗒	dieiiu	dieiiu
咀	jiiaee	jii
祺	qheiie	qhei
匾	nhoaeu	nh
锚	taeiii	tae
乓	yuieie	yuie
萃	pvoeuo	pvoe
贻	kfaoia	kfaoi
揖	kgiaee	kgiae
觑	qgieau	qgi
吝	lfiaee	lfiae
憔	qwuioe	qwui
羌	qsaaaa	qsaa
砾	ltuaiu	ltu
蠕	seeoai	seeo
诲	wfueaa	wfue
肴	ksuoeu	ksuo
撩	lgeuoo	lgeu
坍	vluaoe	vlu
酥	bwueiu	bwu
袅	xpuaoa	xpu
黝	klaaoa	kla
俾	njuiae	njui
嫣	kmeiei	kmeie
穹	qsaeaa	qsae
秧	khiaeu	khiae
妊	smueie	smu
溉	roaeea	roa
聿	kmiiii	kmii
鹊	qneiie	qne
疙	rbueaa	rbue
蘑	tvoeue	tvoeu
睾	ruiaii	ruia
楷	cdeaua	cdea
茹	svauei	svau
酵	jweieu	jwei
锌	haoeou	haoe
滇	doeiia	doeii
纂	cuiaee	cui
辗	gkaeue	gkae
圭	rleiee	rle
幔	tziaee	tzia
褒	nfuiia	nfui
揍	cgeeeu	cgee
倔	jjaeua	jjaeu
诽	mfieee	mfie
腓	msieee	msi
颉	hzeiei	hze
锄	zaiaee	zaia
嗔	zieiia	zieii
磺	wteiie	wte
攒	cgueie	cgue
瘩	dbeiiu	dbei
雳	lqeuau	lqeu
吆	kiaaoo	kiaao
悚	bweiae	bwei
墩	dloeia	dloe
彝	kvaaeo	kvaaeo
囱	puiaua	puia
逍	hnioui	hni
辄	gkeiie	gkei
俨	kjeiio	kjeii
桅	sduaeu	sdu
纶	lcuoua	lcuo
悸	jwueiu	jwue
殃	kpiaeu	kpiaeu
帧	gzieia	gzie
俐	ljueiu	ljue
绮	qceuoe	qceu
籽	cmaiee	cma
袒	vpiaee	vpi
孰	ffiaea	ffiae
愫	bweeie	bwee
拌	ngouee	ngo
暨	jleaua	jlea
橙	zdaouu	zda
敖	pyeeie	pyee
赘	gfeeie	gfee
抉	jgaeuo	jgaeu
剌	lmeiae	lmeia
娼	zmiaee	zmia
淤	kooeau	kooea
顼	hreuia	hreu
哝	xioaua	xio
葵	cvaouu	cvao
酣	wweiie	wweiie
麓	lheiuo	lhe
琅	lroaee	lroa
钵	naeiuo	naei
簸	nueiie	nuei
禾	whoooo	whoo
铢	gaueei	gaue
璧	nraeui	nrae
娠	fmeuee	fmeu
彗	wreeei	wree
惋	swooau	swo
腋	ksoeui	kso
螂	leoaee	leo
阪	nxuuao	nxu
劾	wwoeau	wwoe
掣	zgueei	zguee
嚓	piooau	pio
沥	loeuau	loeu
粱	lmooea	lmoo
惮	dwouia	dwo
氖	xcauuu	xcau
捎	fgioui	fgi
羔	rsoooo	rso
俟	qjaoue	qjao
渲	hoooae	hooo
榄	ldiiue	ldii
茧	jviaei	jviae
霓	xquiea	xqu
胥	hdiaee	hdia
鹉	sneeie	sne
撬	qgueea	qgue
橘	jdaoai	jdao
琶	yreeie	yree
拈	xgieia	xgie
笆	nuaiea	nuai
亟	jaiiae	jaii
痊	qbuoee	qbu
渭	soiaei	soiae
狙	jkiaee	jkiaee
珂	creiae	crei
刨	ymuaae	ymu
蜕	veouia	veo
谚	kfoeou	kfoeo
憧	zwoeou	zwoeo
瞟	yyeiai	yye
拗	pgaaoa	pgaa
馒	tbiaee	tbia
帚	groaia	groa
钗	zaaooo	zaa
哧	zieieu	zieie
喋	dieiie	dieiie
箫	huaeei	hua
刁	daeeee	daee
怦	yweoue	yweo
缭	lceuoo	lceu
湄	toaieu	toa
迥	jniaia	jniai
渝	kouoei	kouoe
磐	ytuuao	ytu
冗	spuaaa	spua
闵	ttoeuo	ttoe
噶	rieiii	rieii
黏	xhuoio	xhu
蕃	mvuoue	mvuo
弼	nheuia	nhe
驿	kpaoee	kpa
淄	coaaai	coaa
饺	jboeuo	jbo
踞	jqaeue	jqaeu
韬	vquoou	vquo
婷	vmoeia	vmoe
唆	biaouo	biao
蜒	keuiea	keu
偎	sjiaei	sji
榨	gdooau	gdooa
漉	looeua	looeua
皈	rkuuao	rkuu
矜	jauooa	jauo
碉	dtuaei	dtu
笈	juuaoo	juua
枷	jdauia	jdau
鲨	fzooei	fzo
蹑	xqeiie	xqe
瀚	woeiia	woeiia
癖	ybaeui	yba
谑	hfieau	hfie
酪	lwuaoi	lwua
揩	cgeaua	cgea
炙	gyuaoo	gyuaoo
烬	jyaeuo	jya
蜷	qeouee	qeo
侏	gjueei	gjue
凋	dzuaei	dzu
漪	kouaue	kouau
悻	hweieo	hweie
讪	ffiaii	ffiai
蹋	vqiaee	vqiae
搐	zgoeaa	zgoe
碘	dtiaei	dtia
帛	nkiaii	nkiai
诠	qfuoee	qfuo
碾	xteaeu	xte
擂	lgeoai	lgeo
苯	nveiuo	nve
诃	wfeiae	wfei
铎	daaoee	daa
戊	sieuau	sieu
荀	hvuaia	hvua
攫	jgeeia	jgee
驹	jpuaia	jpua
憬	jwiaee	jwia
哽	rieiae	rieia
踵	gqueia	gqu
蟒	teeiie	tee
漾	koouee	koouee
啧	cieeie	cieei
吮	fiaoua	fia
楠	xdeiia	xde
氟	mcaeau	mca
怂	bwuouo	bwuo
叼	diaeee	diae
偕	hjeaua	hjea
漩	hooeau	hooe
竣	jnaouo	jnao
翌	kzoeou	kzoeo
蹭	pqouea	pqo
挝	sgeioo	sgeio
臆	ksoeou	ksoe
崽	cqiaei	cqia
绚	hcuaia	hcua
糜	tmoeue	tmo
瘢	nbuuao	nbuu
跤	jqoeuo	jqoe
恬	vwueii	vwu
阑	lteiao	ltei
豢	wiouee	wiou
汶	sooeuo	sooe
跷	qqeaue	qqea
琵	yseeie	ysee
憨	wwaeii	wwae
蜗	seiaei	seia
螅	heuiae	heui
惴	gwiaie	gwia
戟	jieiia	jiei
匮	chiaei	chiae
恙	ksoaoo	ksoa
抿	tgaeae	tgae
桢	gdieia	gdi
笺	jueeau	juee
瞳	vyoeou	vyo
蛤	weuoei	weuo
瓢	yjeiai	yje
潦	loeuoo	loeuo
秤	zheoue	zhe
芹	qvuuei	qvu
跺	dquaei	dqua
哒	dieuoo	dieu
饬	zbueau	zbue
栩	hdaoea	hda
曦	hkouee	hkou
骷	cweiia	cweii
丕	yeuioe	yeu
卤	lheeee	lhee
嫡	dmoeou	dmoe
鬓	nqooau	nqo
梓	cdoeou	cdoe
嗖	biuiea	biu
惦	dwoeui	dwoe
浚	joaouo	joao
咔	ciieei	ciiee
荃	qvuoee	qvuo
藐	tvuoou	tvu
唧	jiaeea	jiae
玺	hruaiu	hru
汛	hoaeii	hoa
铐	caeieu	cae
髅	lwouei	lwou
渤	noeioa	noe
皿	tseeee	tsee
箍	rueiee	rueie
馅	hbuaui	hbua
戍	fieuoa	fieu
汾	mouoau	mouoa
痔	gbeiee	gbei
褶	gpaoea	gpa
聆	lxuooa	lxuoo
汞	riiauo	riia
涎	houiea	houi
奂	wmiaeu	wmi
巅	dqeiia	dqe
渍	coeeie	coee
疣	kbeuao	kbe
傩	xjaoui	xja
逵	cneieu	cnei
耆	qkeieu	qkei
蟋	heuoue	heuo
鳄	pziaei	pzia
讹	pfuiua	pfu
膺	kbuiui	kbuiu
蹿	pqooau	pqoo
沂	kouuei	kouu
筏	muuiea	muu
釜	mweeio	mwee
坯	yleuio	yleu
峦	lqoeii	lqoe
摒	ngaeuo	ngae
茬	zveuie	zve
蟀	feoeaa	feoe
撵	xgeeuo	xgee
浒	wooaue	wooau
缤	ncooau	ncoo
嵋	tqaieu	tqa
珑	lreuau	lreu
苞	nvuaae	nvu
瑾	jreiie	jrei
暧	pkuoou	pkuo
泵	ntiauo	nti
钾	jaiaee	jaia
赓	rbaeeu	rbae
叟	bduiea	bdu
佚	kjueeu	kjue
沓	doiaee	doia
撂	lgiaei	lgia
晏	kkooaa	kkoo
璐	lriaei	lria
甥	fxeeie	fxee
蛊	reiaii	reia
漳	gooeou	gooe
瘪	nbuiae	nbui
阉	kteuoi	kteu
蹂	sqaoai	sqao
琏	lreaei	lrea
鳃	bziaei	bzi
湃	youeeu	youe
辘	lkoeua	lkoe
僭	jjeaua	jjeau
躏	lqeiio	lqeii
鼾	wxeeii	wxe
懵	tweiii	tweii
寐	tpaieu	tpa
褚	zpeieu	zpeie
镰	laoeuo	lao
攥	cgueoi	cgueo
涧	jooiai	jooi
蝙	neoaeu	neoa
脐	qsoeuo	qsoeu
辕	kkeiei	kkeie
杞	qdaeaa	qdae
涣	wouaia	woua
煜	kyiaee	kyia
骥	jpieeu	jpie
傣	djeeeu	djee
嗳	piuoou	piuo
祯	ghieia	ghie
酉	kweeee	kweee
捺	xgeuoe	xgeu
瑕	hraeie	hra
秸	jheiei	jheie
鑫	hauoee	hauo
馋	zbuaia	zbua
窿	lsiuao	lsiu
楔	hdeeei	hdeee
胱	rsioue	rsio
荔	lvauau	lva
蟆	teeiii	teei
屹	kqueaa	kque
湍	voiaie	voia
轲	ckeiae	ckeia
遐	hnaeie	hnae
镯	gaiaii	gaia
缰	jceiae	jcei
桦	wduiua	wdui
炖	dyeaia	dyea
啬	blouei	blouei
羚	lsuooa	lsuo
诩	hfaoea	hfao
钡	naiauo	nai
绯	mcieee	mci
掖	kgoeui	kgo
涸	woiaei	woiae
塾	floeia	flo
鸳	knuaoa	knuao
呸	yieuio	yieu
抡	lguoua	lguou
擞	bgouei	bgo
熹	hyeiei	hyei
坷	cleiae	clei
亘	reiaee	reiae
嗟	jiouee	jiou
瓮	sruoao	sru
筵	kuuiea	kuu
跛	nqauia	nqa
汕	foiaii	foiai
欤	kbeaeu	kbea
壑	wlieoa	wlie
颍	kzuaia	kzua
姗	fmuaua	fmuau
溥	yoeiae	yoeiae
踊	kqaoia	kqa
暄	hkooae	hkoo
枭	hduaoa	hduao
稷	jhiaei	jhia
跚	fquaua	fqua
涟	loeaei	loea
瀛	kooeai	kooeai
笙	fuueei	fuu
滕	vsouee	vsoue
踝	wqiaee	wqi
瞰	cyaeii	cya
贰	pfeeei	pfee
恻	pwiauo	pwiau
嚏	vieioa	vieio
獗	jkeuou	jkeu
迢	vnauia	vnau
睑	jyuoeo	jyu
邯	wxeiie	wxei
珥	preiie	pre
萦	kceiio	kceii
赡	ffuaeu	ffua
酮	vwiaei	vwia
璞	yreiio	yrei
羹	rsoooo	rsoo
缄	jceuei	jceu
俸	mjeeeu	mjee
媲	ymuiau	ymui
晾	lkoeia	lkoei
鸾	lnoeii	lno
恿	kwaoia	kwaoia
蜿	seooau	seoo
扈	wbiaea	wbi
犊	dxeiao	dxei
蜈	seiaee	seiae
讷	xfiauo	xfi
戌	hieuea	hieue
翟	dzuioe	dzui
蓓	nvuioe	nvui
藕	pveeei	pvee
谀	kfuiea	kfuie
谩	tfiaee	tfia
卯	txuaua	txu
岐	qqeiao	qqeia
谙	pfoeou	pfo
荼	vvuoee	vvuo
蝎	heiaee	heia
椰	kdeiie	kdei
甄	greiai	gre
蟾	zeuaeu	zeua
蹊	qquoou	qquo
镀	daoeue	dao
撸	lguaia	lgua
泞	xoooae	xooo
螃	yeoeou	yeo
檬	tdeiio	tde
猓	rkiaee	rkia
羲	hsueiu	hsue
蔷	qveiou	qve
瘸	qbauia	qba
蘸	gvauae	gvau
蔗	gvoeue	gvoe
傀	rjuiae	rju
蚌	neeeei	neee
锢	raiaei	raia
恚	wweiee	wweie
遽	jnieau	jnie
邃	bnooau	bnoo
皑	pkiaia	pki
簌	bueiae	bue
锵	qaoeiu	qao
昊	wkeeuo	wkee
焙	nyoeou	nyoe
鹳	rneiii	rne
睽	cyaouu	cyao
刽	rmuoee	rmu
呗	niiauo	nii
噎	kieieo	kieie
寰	wpiaii	wpiai
鳖	nzouia	nzo
唷	kioeao	kioea
殡	npooau	npo
恣	cwoeua	cwoeu
淖	xoieia	xoie
睐	lyeoue	lyeo
诰	rfueie	rfue
婵	zmouia	zmo
榈	ldoiai	ldoi
氦	wcoeau	wco
蛹	keaoia	keao
靳	jkuuei	jkuu
惬	qweeou	qwee
蹙	pqeuie	pqeu
鸯	kniaeu	kniaeu
眈	dyoaua	dyoa
罡	reeiei	ree
诙	wfeuou	wfeuo
缮	fcouee	fco
胤	kuaaoi	kua
皋	rkeuoe	rke
蛀	geoeei	geo
偌	sjeiie	sjeii
疵	pbieie	pbie
绛	jcuaoe	jcuao
葆	nvuiia	nvuii
喙	wiaaeu	wiaa
黔	qluooa	qluo
佼	jjoeuo	jjoe
儡	ljiaei	ljia
斓	lfoiae	lfoi
烽	myuaoe	myu
嫔	ymooau	ymoo
颚	pziaei	pziae
龈	cuaeea	cua
娓	smaeuu	sma
盅	gsiaei	gsia
坂	nluuao	nluu
町	vbeiii	vbei
瘠	jboeuo	jboe
芥	jvuoui	jvuo
啜	ziaoao	ziao
挎	cgeuoe	cgeu
橇	qdueea	qduee
荟	wvuoee	wvuo
阂	wtoeau	wto
垛	dluaei	dlua
淇	qoeiie	qoeii
瓒	crueie	cru
篓	luouei	luou
虱	feauia	fea
跻	jqoeuo	jqoeu
蹒	yqeiie	yqei
髯	sqiaie	sqia
龛	cjeiae	cjei
痫	hboiae	hbo
瞠	zyiouo	zyio
掂	dgoeui	dgoe
潼	vooeou	vooe
酰	hwueie	hwue
镁	taouee	tao
灸	jyuaoo	jyua
筱	huuiiu	huu
腆	vsiaei	vsia
谆	gfoeia	gfoe
壬	slueie	slue
椋	ldoeia	ldoe
茗	tvuaoi	tvua
骋	zpiaei	zpi
蛔	weiaia	weia
潺	zoaeua	zoae
扉	mbieee	mbi
耘	kxeeao	kxee
槟	ndooau	ndoo
甬	kfaoia	kfaoia
雹	nquaae	nqua
淞	boeiuo	boe
谥	ffoueu	ffou
燎	lyeuoo	lyeu
蕙	wveiae	wvei
蚪	deooei	deo
蜻	qeeeie	qee
轶	kkueeu	kkue
郸	dxouia	dxou
楣	tdaieu	tda
狰	gkuaae	gkuaa
捋	lguoou	lguoo
涓	joiaei	joiae
荪	bvaiei	bvaie
娄	lmauee	lma
麝	fhuiae	fhu
薰	hvueia	hvue
蚤	ceaooi	cea
醮	jwuioe	jwui
搪	vgoeua	vgoe
湮	koeiai	koei
瞌	cyeiea	cyeie
谧	tfoaou	tfoa
辍	zkoaoa	zko
梆	ndeeeu	ndeee
樟	gdoeou	gdoeo
茉	tveeiu	tvee
岖	qqeuoa	qqeu
癣	hbuaia	hbuai
穑	bheiou	bhei
臼	jkeeee	jkee
玷	drieia	drie
馍	tbeiii	tbe
呷	riiaee	riiae
妩	smeeua	smee
萼	pviaei	pvia
伫	gjooae	gjoo
彤	vguaoe	vguao
媛	kmuoou	kmuo
岬	jqiaee	jqia
莓	tvueaa	tvue
惆	zwuaei	zwua
鳎	vziaee	vzia
啾	jiueiu	jiue
囔	xioaia	xioa
蜓	veueie	veu
孺	sheoai	sheo
徇	htuaia	htua
徵	gtiaie	gtia
岱	dquiea	dqui
昵	xkaeuu	xka
焊	wyiaee	wyi
卅	beuiii	beu
邙	txoeaa	txo
飙	nxeuoo	nxeu
痞	ybeuio	ybeu
隼	beeiii	bee
恫	dwiaei	dwia
怆	zwuoaa	zwuo
桀	jduaoe	jdua
绶	fcuoou	fcu
裆	dpioua	dpi
桧	rduoee	rduo
盂	kseeii	ksee
蚓	keaeai	keae
嗷	pieeie	piee
抠	cgeuoa	cgeuo
槌	zduiae	zdui
痘	dbeiae	dbeia
痢	lbueiu	lbue
芮	sviauo	svi
蚣	reuoao	reu
铿	caiiao	cai
闩	fteeee	ftee
飓	jxiaee	jxi
疱	ybuaae	ybu
蝌	ceueiu	ceu
撅	jgeuou	jgeu
蚯	qeuiei	qeu
斡	sliaee	sli
窠	csiaee	csi
荚	jveoue	jveo
耷	dieiie	dieiie
牒	dceiie	dce
砚	ktiaua	kti
煦	hyiaee	hyi
赈	gfeuee	gfeue
嗫	xieiie	xieii
耙	nxaiea	nxa
榕	sdooau	sdoo
鞑	dkeuoo	dkeu
袤	tfaoai	tfao
谌	zfeiie	zfei
醺	hwueia	hwuei
秆	rheeii	rhee
徨	wtuiae	wtui
橹	lduaia	lduai
翡	mzieee	mzi
缨	kciauo	kci
锹	qaueiu	qaue
嵇	jheuao	jheua
圪	rlueaa	rlue
髻	jqeiei	jqei
嗬	wieiiu	wieiiu
痣	gbeieo	gbeie
辎	ckaaia	cka
娩	tmuaia	tmu
蛐	qeiaei	qeia
谄	zfuaui	zfu
鹞	knuoou	knuoo
翱	pzuiae	pzu
庖	ybuaae	ybua
籁	lueiae	luei
蓿	hvooau	hvoo
鳗	tziaee	tziae
疟	xbeaee	xbe
鲇	xzieia	xzi
嚅	sieoai	sieo
瘀	kboeau	kboe
颔	wzuooa	wzuo
黜	zlaiia	zlai
黠	hleiei	hlei
濑	loeiae	loei
忐	vwieeo	vwie
洵	houaia	houa
馁	xbuoou	xbu
忑	vweioo	vwei
砥	dtuaea	dtua
咂	cieiai	cieia
罹	leooiu	leoo
糠	cmoeua	cmoe
偃	kjeiae	kjeia
匝	chiaii	chiaii
淙	poooae	poo
喏	xieiie	xieiie
祛	qheiea	qheie
纫	scauoo	scau
闾	ltiaei	lti
腼	tseuia	tseu
蛰	geeieu	gee
曜	kkaoea	kkao
涝	loeiio	loeii
厩	jcaeea	jcae
洄	woiaia	woiai
煊	hyooae	hyoo
疽	jbiaee	jbia
闰	steeie	stee
汐	houaoo	houao
璜	wreiie	wreii
藓	hvuaia	hvuai
铬	rauaoi	raua
渥	soaeue	soae
靼	dkiaee	dkia
噤	jieiuo	jieiu
苓	lvuooa	lvuo
酗	hwuoai	hwuoa
咫	gqoiae	gqoi
椿	zdeeeu	zdee
鲫	jzaeea	jzae
罔	shoueo	shou
锭	daooae	daoo
锺	gaueia	gauei
匍	yteiae	ytei
祗	ghuaea	ghua
锰	taaiei	taa
岌	jquaoo	jqua
畹	sbooau	sbo
馀	kbuoee	kbuo
熠	kyaoea	kya
糯	xmeoai	xmeo
胫	jsaoei	jsao
銮	laoeii	laoe
旌	jgueue	jgueu
棣	ddaeei	ddae
沅	koeeua	koee
孢	nhuaae	nhu
豌	saooau	sao
熵	fyoeou	fyoe
盹	dyeaia	dyeai
腌	kseuoi	kseu
镭	laeoai	laeo
驸	mpuiei	mpui
镐	waoeia	wao
馐	hbouee	hbou
嘤	kiiauo	kiiau
癞	lbeiae	lbe
骰	vwuaao	vwua
瞑	tyoaia	tyoa
裨	npuiae	npui
阖	wteiea	wtei
韭	jeieee	jeie
宕	dpeuia	dpe
戾	lbeuoo	lbeu
镌	jauioe	jaui
溟	tooaia	tooa
牍	dceiao	dcei
隽	jeauuu	jea
婊	nmeeie	nme
鹄	wnueie	wnu
埂	rleiae	rlei
拄	ggoeei	ggoee
娲	smiaei	smi
虬	qeaaaa	qeaa
萱	hvooae	hvooa
啵	niooea	nio
蠡	leaaeu	lea
芋	kveeii	kveei
胭	ksiaeu	ksiae
豺	zjeiuu	zje
啻	zioeou	zio
褛	lpouei	lpou
蛆	qeiaee	qeiae
掰	nguoau	nguoau
柠	xdooae	xdo
篆	guaaeu	gua
倌	rjooai	rjoo
咛	xiooae	xioo
蛭	geeaoe	geea
澹	douaeu	doua
纭	kceeao	kcee
荨	qvaeee	qva
莞	rvooae	rvo
谡	bfiaei	bfi
潞	loiaei	loia
郅	gxeaoe	gxea
弋	keoooo	keoo
螳	veiouo	vei
飕	bxuiea	bxui
胄	gsiaei	gsiae
蟑	geoeou	geoe
宓	tpoaou	tpo
昙	vkeeao	vke
猥	skiaei	ski
蟠	yeuoue	yeuo
锏	jaoiai	jaoi
匐	mteiae	mte
柑	rdeiie	rdeii
濮	youiii	youii
烯	hyuoeu	hyuo
蟮	feouee	feou
仄	ccuooo	ccuo
偈	jjiaee	jjiae
箴	gueuei	gueu
粼	lmuaoe	lmu
蜃	fhiaei	fhia
嗥	wiuiae	wiuia
褴	lpiiue	lpii
蕨	jveuou	jveuo
圩	sleeii	sle
蓟	jvuaia	jvuai
孪	lhoeii	lhoe
杳	kdiaee	kdia
魇	kceuoo	kceuo
簪	cueaua	cuea
荤	wkeiio	wkei
诿	sfueiu	sfue
氲	kciaee	kcia
摞	lgiaei	lgiae
镂	laouei	laou
飒	bnuauo	bnu
夙	bheuao	bheu
舀	kjuiea	kjui
臧	cieuae	cieua
蒿	wvoeia	wvoe
貂	djauia	dja
蜥	heeiuo	heeiu
蹩	nqouia	nqou
噼	yiaeui	yia
钛	vaeuoo	vae
钚	naeuio	naeu
濂	looeuo	looeuo
獾	wkeiii	wkeii
皙	hkeiuo	hkeiuo
铠	caiaia	caia
霭	pqoaia	pqoa
鲈	lzieae	lziea
叵	yhiaee	yhi
霾	tquoou	tquo
泯	toaeae	toae
碴	zteiuo	ztei
鸵	vnooau	vno
峪	kquouo	kquo
饕	vbiaee	vbi
瘁	pboeuo	pbo
睢	byuioe	byu
纣	gceioo	gce
迩	pnuaiu	pnu
鬃	cqooae	cqoo
夔	criaee	cri
垠	klaeea	klae
榭	hduiae	hdui
饨	vbeaia	vbea
娑	bmooei	bmo
篝	rueeii	rueei
隍	wxuiae	wxu
榔	ldoaee	ldoa
洌	loeuao	loeua
浜	nouiei	nou
鲑	rzeiee	rze
汩	roiaee	roi
浣	woooae	wooo
舐	fuuaea	fuua
谔	pfiaei	pfiae
忻	hwuuei	hwuu
咻	hiuiei	hiuie
唑	ciuouo	ciuo
鹑	znoeia	zno
懋	tweiuo	tweiu
皎	jkoeuo	jkoeuo
诒	kfaoia	kfaoia
麾	wuoeue	wuo
辏	pkeeeu	pkeee
冽	lzeuao	lzeu
氐	duaeao	duae
箕	jueiie	juei
俚	ljiaee	ljiae
宸	zpeuee	zpeu
汴	nooeio	nooe
捱	pgeuei	pgeue
芍	fvuaoo	fvua
摈	ngooau	ngoo
摺	ggaoea	ggao
簦	duaouu	duao
咝	biaaaa	biaa
箔	nuooeu	nuoo
孀	fmeoai	fmeo
怏	kwiaeu	kwia
谝	yfoaeu	yfoa
漕	poeiae	poe
砧	gtieia	gtie
罂	kyiauo	kyiau
耄	tlueea	tlue
馕	xbeiae	xbei
栾	ldoeii	ldoei
榘	jdueeu	jdue
沣	moeeei	moe
烷	syooae	syoo
俑	kjaoia	kjao
榷	qdoaui	qdoa
沱	voooau	vooo
缜	gceiia	gcei
鹫	jnoeia	jnoe
蛳	beiuei	bei
剽	ymeiai	ymei
泗	boiaua	boi
衢	qtiaee	qti
臊	bsiaei	bsia
瘴	gboeou	gbo
晁	zkuoea	zku
纾	fcaoai	fcao
酚	mwuoau	mwuoa
孛	nloaai	nlo
炀	kyauuu	kyau
叁	bleuoe	bleu
憩	qwueii	qwue
掬	jguaou	jguao
椤	ldiaii	ldia
啮	xiieie	xiie
畿	jaaaoe	jaaa
掸	dgouia	dgou
镣	laeuoo	laeu
骁	hpeaue	hpea
侗	djiaei	djiae
椽	zdaaeu	zdaa
泓	woaeaa	woae
滦	looeii	looei
癜	dbaeue	dba
荩	jvaeuo	jvae
蚱	geueie	geuei
酯	gwuaia	gwua
庑	sbeeua	sbee
扪	tgoiaa	tgo
歆	hguauo	hgua
癸	rvouuo	rvou
蚜	keeaiu	keea
蝮	meueia	meue
蹶	jqeuou	jqeu
弈	kvoeui	kvoe
庋	rbeiao	rbei
喟	ciiaei	ciiae
滂	yooeou	yoo
啕	viuaue	viua
蛎	leeuea	leeu
槁	rdoeia	rdoe
獭	vkeiae	vkei
翊	knaoea	kna
龊	zuiaei	zuia
燮	hdoeee	hdoe
莘	fvoeou	fvoe
邺	klaiii	klai
剁	dmuaei	dmua
觐	jgeiie	jgei
铛	daioua	dai
臃	ksoeaa	ksoea
谗	zfuaia	zfua
镍	xauiae	xau
墒	floeou	floe
晔	kkuiua	kkui
燔	myuoue	myuo
嘭	yieiei	yieie
涿	goeuau	goeu
醯	hwoeao	hwo
箩	luiaii	luia
睨	xyuiea	xy
鄱	yxuoue	yxu
坳	plaaoa	plaa
砷	ftiaee	ftia
诤	gfuaae	gfua
鹭	lniaei	lnia
唏	hiuoeu	hiuo
伲	xjaeuu	xjae
殁	tpuaao	tpu
猬	skiaei	skia
琥	wrieau	wri
蚩	zeaiie	zeai
泾	joaoei	joaoe
缥	yceiai	yce
殓	lpuoeo	lpuo
鳅	qzueiu	qzu
刍	zmaeee	zma
嶙	lqouei	lqou
氰	qceeie	qcee
舫	mroeau	mro
芷	gvieie	gvi
诋	dfuaea	dfua
逅	wnuuei	wnuu
呓	kieiia	kieiia
唰	fiaeui	fiae
妫	rmouao	rmoua
茁	gvaiia	gvai
馑	jbeiie	jbe
骧	hpoeia	hpo
峋	hquaia	hqu
擢	ggaoea	ggaoe
苷	rveiie	rvei
袂	tpaeuo	tpae
懑	twooee	twoo
蓑	bvoeia	bvo
涞	loeoue	loeo
祉	ghieie	ghiei
踹	zqiaie	zqi
噫	kioeou	kioeo
掇	dgaoao	dga
沏	qoeaau	qoea
诳	cfuaue	cfuau
饽	nbeioa	nbei
绺	lcuaoi	lcua
饪	sbueie	sbu
谘	cfoeua	cfoeu
迳	jnaoei	jnaoe
飧	bhuooa	bhu
铡	gaiauo	gaiau
枞	pduouo	pdu
熨	kyaeue	kyae
荭	wvaaee	wva
鋈	saooeu	saoo
俦	zjeeeu	zjee
戛	jieuia	jieu
赊	ffuoee	ffuo
幺	klaaoo	klaa
湎	toeuia	toeu
凇	bzeiuo	bze
芪	qvuaea	qvua
觯	gvouia	gvou
龌	suaeue	suae
嘁	qieuie	qieui
嬴	kmoeai	kmo
挞	vgeuoo	vgeu
苻	mvuiei	mvui
鞯	jkeiie	jkei
肽	vseuoo	vseu
恸	vweeao	vwee
迨	dnaoia	dnao
钰	kaeeie	kae
儆	jjeiiu	jjeii
觎	kguoei	kguoe
讫	qfueaa	qfue
僮	vjoeou	vjoe
媾	rmeeii	rmee
滓	coooao	cooo
龇	cuieie	cuie
斛	wvooei	wvoo
杈	zdaooo	zdao
涮	foaeui	foae
疸	dbiaee	dbia
绾	scooai	scoo
胯	cseuoe	cseuo
觥	rvioue	rvio
赳	juaiii	juai
卞	nfiooo	nfio
愠	kwiaee	kwiae
庠	hbouee	hboue
拮	jgeiei	jgeie
烨	kyuiua	kyui
窈	ksaaoa	ksaa
菠	nvooea	nvoo
罄	qyeiea	qye
咣	riioue	riio
囤	dheaia	dhea
奘	ciaieu	ciaie
弁	nleuii	nleu
缫	bcaaai	bca
腴	ksuiea	ksui
缈	tciaee	tci
喵	tieiii	tiei
柚	kdiaei	kdiae
潢	woeiie	woeiie
遛	lnuaoa	lnu
琨	criaee	cria
荻	dvuauo	dvua
藜	lvueiu	lvue
郏	jxeoue	jxeo
镳	naoeua	naoe
雉	gauioe	gaui
橐	vdeiae	vde
艮	rloooo	rloo
蛉	leuooa	leuo
骈	ypouee	ypo
寮	lpeuoo	lpeu
搽	zgeiiu	zge
柩	jdeuao	jdeu
濡	soeoai	soeo
佗	vjooau	vjoo
啷	lioaee	lioa
诜	ffueie	ffue
偻	ljouei	ljo
夯	wiauuu	wiau
闱	steeai	steea
夥	whiaee	whiae
枸	rduaia	rdua
筠	kueieu	kuei
膑	nseooa	nseoo
虻	teoeaa	teoea
谖	hfuoou	hfuo
埽	blaeeo	bla
笞	zuaoia	zua
臾	kkuooo	kkuo
婀	pmaiei	pma
珞	lruaoi	lrua
粑	nmaiea	nmai
崂	lqeiio	lqeiio
怵	zweiuo	zwe
殒	kpiaei	kpiaei
绻	qcouee	qco
觊	jgiaia	jgiai
嗑	cieiea	cieiea
昱	kkoeou	kkoe
榛	gdeeeu	gdeee
颧	qzeiii	qzeii
蜴	keiaee	keia
鳝	fzouee	fzou
噙	qiuooe	qiuo
淼	toiauo	toiau
囿	kheuia	kheu
矾	mtuaoo	mtu
硼	ytuaee	ytua
泅	qoiauo	qoi
蠹	deeiae	deei
邂	hnuaua	hnu
钜	jaeaea	jaea
垩	pleiio	ple
乩	jaieia	jaie
嗝	rieiae	rieiae
淦	rouoee	rouo
樽	cdouei	cdou
诮	qfioui	qfio
啐	pioeuo	pioe
揆	cgaouu	cgao
榉	jdooue	jdoo
淅	hoeiuo	hoeiu
暹	hniaee	hnia
辔	yiaaee	yiaa
馗	cuaoue	cuao
骛	spaoai	spa
鱿	kzeuao	kzeu
犷	rkoeuu	rko
獠	lkeuoo	lkeu
竦	bneiae	bne
苫	fvieia	fvie
詈	leoeee	leoe
篙	ruoeia	ruo
诨	wfoaea	wfo
峒	dqiaei	dqi
滢	koeiio	koeii
蜚	meieee	meie
铰	jaoeuo	jaoe
馄	wbiaee	wbia
琬	srooau	srooa
靓	jqiaua	jqiau
犟	jxaeai	jxaea
狻	bkaouo	bka
璨	prieua	pri
螨	teeiie	teeii
鸬	lnieae	lnie
嘹	lieuoo	lieuo
芩	qvuooa	qvuoo
蜇	geeieu	geei
锟	caiaee	caiae
栉	gdeiia	gdeii
洹	woeiae	woeia
俪	ljeiao	ljeia
钍	vaeiee	vaei
瑁	triaee	tri
锨	hauuei	hauu
壹	kloaei	klo
痿	sbueiu	sbue
犄	jxeuoe	jxeu
瘙	bbaooi	bbao
粕	ymuiae	ymuia
抟	vgeeao	vgee
衲	xpiauo	xpi
饯	jbeeau	jbee
踮	dqoeui	dqoeu
龅	nuuaae	nuu
愎	nwueia	nwu
馥	mhiaee	mhia
梏	rdueie	rdue
艿	xvauuu	xva
讣	mfiooo	mfio
趺	mqeeuo	mqe
邝	cbaiii	cbai
鲟	hzaeee	hzae
剜	smooau	smooau
笥	buaeia	buae
绉	gcuaae	gcua
罅	hyieau	hyie
衩	zpaooo	zpao
姣	jmoeuo	jmoeu
斫	gtuuei	gtu
鹗	pniaei	pnia
晗	wkuooa	wkuo
爻	kuouoo	kuo
猕	tkaeau	tkae
窕	vsuoea	vsu
铩	fauoei	fau
仨	bjeeee	bje
崴	sqeuea	sqe
搡	bgaoao	bgaoa
酢	pwueie	pwue
佞	xjeeau	xjee
檄	hduiae	hduia
璀	priaiu	pria
岷	tqaeae	tqae
舛	zheaii	zhea
邕	kbiaea	kbi
铂	nauiae	nau
霁	jqoeuo	jqoeuo
犒	cxoeia	cxo
阈	kteiae	kteia
馏	lbuaoa	lbuao
麋	thouei	thou
麒	qheiie	qheii
妍	kmeeui	kmee
宥	kpeuia	kpeu
摁	pgiaeu	pgiaeu
涔	poiaiu	poi
苁	pvuouo	pvuou
铤	daueie	daue
锷	paiaei	pai
嗲	diuouo	diuo
恽	kwoaea	kwoa
麂	jhuaaa	jhua
胛	jsiaee	jsia
赝	kcuiui	kcuiu
哂	fieiau	fieia
呶	xiauea	xiau
噘	jieuou	jieuo
懔	lwoeia	lwoe
撷	hgeiei	hgei
栎	lduaiu	lduaiu
桎	gdeaoe	gdea
霰	bqeiie	bqe
飨	hbaauu	hba
噔	diaouu	diao
娣	dmouae	dmou
揄	kguoei	kguoei
咤	giooau	gio
忝	vweeuo	vweeu
薏	kvoeou	kvoeo
嗵	viaoia	viao
泸	loieae	loiea
胪	lsieae	lsie
贲	nfeiei	nfei
迤	knueai	knue
鍪	taaoai	taao
僖	hjeiei	hjei
刈	kmuoii	kmuoi
咿	kiuiae	kiui
蔫	xveiei	xvei
鹌	pneuoi	pneu
嗪	qieeeu	qieee
岫	hqiaei	hqia
嵘	sqeiio	sqei
怼	dwaoei	dwao
茏	lveuau	lveu
茯	mvuieu	mvuie
轱	rkeiia	rkei
铨	qauoee	qauo
昕	hkuuei	hkuu
咩	tiouee	tioue
澧	loiaei	loiae
郢	kxiaee	kxiaee
馊	bbuiea	bbu
髡	cqeuaa	cqeu
濯	goaoea	goao
盥	rsuiee	rsui
苣	jveaea	jvea
囡	xhauee	xhau
砺	lteuea	lteu
佘	fjeeiu	fjeeiu
弑	fuiuoe	fuiu
楂	gdeiuo	gdeiu
翦	jzouei	jzou
谶	zfuouo	zfuo
怩	xwaeuu	xwae
楹	kdauao	kdau
蠼	qeiaee	qeiaee
霏	mqieee	mqi
讴	pfeuoa	pfeu
锲	qaeeei	qaee
慵	kwoeua	kwoe
砭	ntuoao	ntuo
胝	gsuaea	gsuae
杵	zdueei	zdue
樾	kdeiei	kdeie
潍	soaaeu	soaa
帼	rziaee	rzi
碣	jtiaee	jtia
啶	diooae	dioo
徕	lteoue	lteo
胴	dsiaei	dsia
裟	fpooei	fpo
诌	gfuaae	gfuaa
钴	raeiia	raei
楫	jdiaee	jdia
赭	gzeieu	gze
铣	haueie	hauei
铱	kaoeua	kaoe
碛	qteiae	qtei
酊	dweiii	dwei
醛	qweiiu	qweii
魑	zlooeu	zloo
剐	rmiaei	rmia
畦	qbeiee	qbe
闶	ctoeua	ctoe
阄	jtuaia	jtuai
陂	nxauia	nxau
祚	chueie	chue
鹘	rwuaoa	rwua
泱	koiaeu	koia
趄	juiaee	jui
陲	zxueie	zxu
骅	wpuiua	wpui
倜	vjuaei	vjuae
呤	liuooa	liuo
燧	byoueu	byo
郧	kxiaei	kxiaei
铉	haoeaa	haoea
粲	pmieua	pmie
骶	dwuaea	dwua
峁	tquaua	tqua
忸	xwaiee	xwai
戡	cieiie	cieii
渌	loaeei	loaee
骞	qpooae	qpo
髭	cqieie	cqie
苋	hviaua	hvi
蜊	leueiu	leue
谲	jfaoai	jfao
钨	sauaae	sau
锃	caiaee	caiaee
幄	szaeue	sza
戕	qheauo	qhea
虢	rjeioi	rjeio
闼	vteuoo	vte
骊	lpeiao	lpei
傥	vjiouo	vjio
妲	dmiaee	dmi
桠	kdeiio	kdeii
烩	wyuoee	wyuo
绌	zcaiia	zca
袈	jpauia	jpau
揿	qgueee	qguee
杲	rkeiuo	rkeiu
肓	wsoeai	wso
薮	bvouei	bvou
厝	pceiie	pce
氤	kciaeu	kciae
缙	jceiio	jceii
莅	lvuioe	lvui
旖	kgueeu	kgue
硒	hteiau	htei
衮	rfoaou	rfoa
诟	rfuuei	rfuu
唁	kioeee	kioee
嬗	fmoeia	fmoe
硎	hteeui	htee
裱	npeeie	npee
颦	ylueui	ylu
煨	syiaei	syia
礴	nteiio	ntei
纥	wcueaa	wcue
鏖	phuoee	phu
靥	kceuoo	kceuoo
笏	wuuauu	wuu
羿	kzeuii	kzeui
蝈	reiaee	reiaee
湟	wouiae	wouia
炜	syeeai	syee
煲	nyuiia	nyu
甑	crouia	cro
笕	juiaua	juia
锉	pauouo	pauo
鼐	xauiae	xaui
喑	kioeou	kioeou
妪	kmeuoa	kmeu
嶂	gqoeou	gqoe
弭	theiie	thei
浔	hoaeee	hoae
锂	laiaee	laiae
孳	chouea	chou
苡	kvaouo	kvaou
醴	lwiaei	lwia
颏	czoeau	czo
渚	goeieu	goeie
蚝	weueea	weue
轭	pkeuaa	pkeu
鹬	knaoai	knao
痨	lbeiio	lbei
耦	pxiaee	pxia
膘	nseiai	nseiai
褡	dpeiiu	dpei
覃	vwiaee	vwiae
邛	qiaiii	qia
篾	tuiaii	tui
馔	gbaeaa	gba
兖	kfuoao	kfuoa
爰	kjeeua	kjee
痂	jbauia	jbau
耨	xxeuee	xxe
艄	frioui	frio
遨	pneeie	pnee
阋	htuiea	htui
昶	zkoaau	zkoa
沤	poeuoa	poeu
焓	wyuooa	wyuoo
秣	theeiu	thee
邋	lnaaai	lnaa
俎	cjuoia	cju
绦	vcuaoe	vcu
榫	bduioe	bdui
蟪	weeiae	weeia
氩	kceiio	kceiio
烃	vyaoei	vya
稗	nhuiae	nhui
謇	jfooae	jfo
锴	caeaua	caea
龉	kueiae	kueia
俣	kjiaee	kjia
嬷	tmoeue	tmoe
痤	pbuouo	pbuo
笫	cuuaiu	cuu
肱	rseuao	rseu
鸢	kneaou	kneao
砣	vtooau	vto
碜	ztaoeu	ztao
芨	jvuaoo	jvuao
莆	yveiae	yvei
菏	wvooee	wvooe
阕	qtaouu	qta
鼹	kriaee	kri
猷	kkouei	kkou
竽	kueeii	kuee
舸	rreiae	rreia
诓	cfeeei	cfeee
錾	caeaie	caeai
姘	ymouee	ymou
婕	jmeaee	jmea
悌	vwouae	vwo
槭	qdeuie	qdeu
淬	pooeuo	pooe
邈	tnuoou	tnu
隗	cxuiae	cxui
歙	fbuoei	fbuo
稹	gheiia	ghei
蹴	pqoeia	pqoe
痈	kbuaee	kbuae
砒	yteaua	ytea
羯	jsiaee	jsiae
豕	fioooo	fio
镏	lauaoa	laua
鲂	mzoeau	mzo
匦	rheaie	rhea
笤	vuauia	vua
蓖	nvuiau	nvuia
峥	gquaae	gqua
徭	ktuoou	ktuo
浃	joeoue	joeo
烊	kyouee	kyou
缢	kcoueu	kcou
翳	kzeuee	kzeue
蚨	meeeuo	meee
褓	npuiia	npuii
趔	lueuao	lueu
酆	mxeeei	mxe
仃	djeiii	djei
勖	hwiaee	hwiaee
泷	loeuau	loeuau
炔	ryaeuo	ryae
葺	qviaee	qvi
蚴	keaaoa	keaa
蛴	qeoeuo	qeoe
誊	vfouee	vfo
赜	chiiae	chii
媸	zmaiie	zmai
俳	yjieee	yjie
孱	pqeaie	pqea
砦	gtieie	gtiei
祜	wheiia	whe
茑	xvuaoa	xvu
诖	rfeiee	rfei
跸	nqeaua	nqea
逡	qnaouo	qnao
伉	cjoeua	cjo
屐	jquuie	jquu
溴	houiae	houia
蛞	ceueii	ceue
飚	nxouuo	nxo
圻	qluuei	qluu
崆	cqooau	cqooa
庾	kbuiea	kbuie
掮	qgoaeu	qgoa
橛	jdeuou	jdeuo
矸	rteeii	rtee
缂	cceiie	cce
蒯	cmeiiu	cmeii
鸨	nnuaei	nnu
啭	gieaie	giea
蛩	qeeieu	qeei
蠖	weeiiu	weeii
诹	cfeiie	cfei
镉	raeiae	raeia
饧	vbauuu	vbau
鸪	rneiia	rnei
劭	fwauia	fwau
哐	cieeei	cieee
崧	bqeiuo	bqei
杼	gdaoai	gdao
棂	ldaeeo	ldae
螫	feeieu	feei
遑	wnuiae	wnui
颢	wziaee	wzia
饔	kboeaa	kboea
龃	juaeee	juae
腱	jsaeee	jsaee
襁	qpaeai	qpae
忾	cwueea	cwuee
濠	wooeia	wooe
牝	yxuaaa	yxua
蛄	reeiia	reei
鲆	yzeoue	yze
嗄	pieuia	pieui
灏	woaeeo	woaee
嘣	niiaiu	niia
夤	khooae	khoo
疥	jbuoui	jbuou
砝	mteiea	mtei
苜	tviaee	tviaee
荞	qvueuo	qvue
颞	xzeiie	xze
忤	swueei	swue
旎	xgueae	xgue
瘛	zbeeei	zbee
辇	xkeeuo	xke
遢	vniaee	vnia
魉	lleiau	lle
娌	lmiaee	lmi
毂	rheieo	rhei
氚	zcuiii	zcui
涫	roooai	rooo
瓤	sjoeia	sjoe
碇	dtooae	dto
臁	lsoeuo	lsoe
荥	hoeiio	hoeiio
吡	nieaua	niea
壅	kloeaa	kloe
毖	nsoaou	nso
玮	sreeai	sree
缛	sceuee	sceu
羟	qsaoei	qsao
珈	jrauia	jra
虼	reueaa	reue
颀	qleuia	qleu
佝	rjuaia	rjua
珏	jreeie	jree
翕	hzuoei	hzu
遴	lnouei	lnou
郛	mxuoou	mxuo
氅	zuioui	zuio
玖	jruaoo	jrua
粽	cmooae	cmoo
诂	rfeiia	rfeii
蹇	jqooae	jqoo
逋	nneiae	nnei
岢	cqeiae	cqei
聒	rxueii	rxu
髁	cwiaee	cwia
淝	mouaee	moua
潆	koeiio	koeiio
芾	mveiai	mvei
闳	wteuao	wteu
鞣	skaoai	ska
髋	cwooae	cwoo
鲎	wsuaia	wsua
黍	fhuoio	fhuo
汨	toiaee	toiae
胍	rsuuao	rsuu
戬	jieiio	jieii
钤	qauooa	qauoo
铵	paooaa	pao
阏	ptoeau	ptoe
鬈	qqouee	qqo
鹜	snaoai	snao
崮	rqiaei	rqia
枰	ydeoue	yde
樯	qdeiou	qdeio
畲	fjeiuo	fjeiu
脍	csuoee	csu
衾	qpuooa	qpu
蹼	yqiiou	yqi
劬	qwuaia	qwua
咭	jieiei	jieie
囫	whuauu	whua
洱	poeiie	poei
刎	smuauu	smua
琊	kreaiu	krea
碚	ntoeou	nto
芏	dveiee	dve
鳕	hzeoai	hzeo
嘧	tiooao	tioo
恂	hwuaia	hwuai
槿	jdeiie	jdei
绀	rceiie	rce
芎	qvaeaa	qvae
谪	gfoeou	gfoeo
鲢	lzeaei	lzea
鲧	rzuaao	rzu
噱	jiieau	jiie
浠	houoeu	houoeu
潸	foeiuo	foei
跏	jqauia	jqau
郦	lxeiao	lxeiao
鲶	xzuooa	xzu
抻	zgiaee	zgiae
琰	krouuo	krou
矍	jdiaee	jdiae
臬	xoeiuo	xoe
苌	zvueao	zvuea
鹚	pnouea	pno
龆	vuauia	vuau
呔	dieuoo	dieuo
芄	svuaoo	svua
觞	fvueau	fvue
雒	leuaoi	leua
槎	zdouee	zdou
舂	zkeeeu	zkee
钒	mauaoo	maua
阒	qtiaee	qtia
饫	kbueuo	kbue
鸩	gnoaua	gnoa
妗	jmuooa	jmuo
稔	shuooa	shuoo
穰	shoeia	shoei
莒	jviaei	jviaei
萸	kvuiea	kvui
蚧	jeuoui	jeu
谠	dfiouo	dfio
阡	qxueii	qxue
餍	kceuoo	kceuoo
芗	hvaauu	hvaa
菸	kvoeau	kvoea
葩	yvuiae	yvui
谯	qfuioe	qfui
踔	zqieia	zqie
佻	vjuoea	vjuo
倨	jjaeue	jjaeue
厣	kceuoo	kceuoo
嘌	yieiai	yieia
蠓	teeiio	teeiio
钏	zauiii	zaui
饩	hbueea	hbue
黩	dleiao	dleia
恁	xwuiue	xwui
殚	dpouia	dpou
缬	hceiei	hceiei
藿	wveoai	wveo
鎏	laooeo	laoo
钿	vaiaei	vaia
呋	mieeuo	miee
囟	huiauo	hui
婺	smaoai	smao
旃	ggueua	ggue
瓯	preuoa	preu
绱	fcioui	fcio
鄣	gxoeou	gxoeo
酩	twuaoi	twua
锶	baiaei	bai
恹	kweueu	kweue
缦	tciaee	tcia
逶	snueiu	snu
鸹	ruuaoa	ruu
媪	pmiaee	pmia
殇	fpueau	fpue
濉	boiaee	boia
篑	cuiaei	cuia
菟	vvuaia	vvuai
螟	teoaia	teoa
讦	jfeeii	jfeei
邬	sxuaae	sxu
醪	lwaoea	lwa
阗	vteiia	vtei
鲛	jzoeuo	jzoe
嫠	lmeeiu	lmee
峤	jqueuo	jque
肼	jseeui	jsee
芡	qvuauo	qvuau
鄯	fxouee	fxo
岘	hqiaua	hqiau
愆	qwuuio	qwuu
掼	rgaaie	rga
焖	tyoiao	tyoi
矽	htuaoo	htuao
聩	cxiaei	cxia
讧	wfeiee	wfeie
卟	niiooo	niio
姒	bmaouo	bma
挈	qgeeei	qgee
杷	ydaiea	yda
砉	wteeei	wtee
笳	juauia	juau
菖	zviaee	zvia
蚋	seiauo	seiau
袢	ypouee	ypou
靛	dqoaei	dqoa
踽	jquiae	jqui
黾	tiaaaa	tiaa
侩	cjuoee	cjuo
凫	mhuaoa	mhua
挲	bgooei	bgoo
笪	duiaee	duia
莜	kvuiiu	kvuii
诔	lfeeei	lfee
郯	vxouuo	vxou
韪	sqiaee	sqiae
鼋	keaeea	keaee
嵊	fqueii	fque
箸	gueieu	gueieu
菅	jvooai	jvoo
裢	lpeaei	lpea
趿	vquaoo	vqua
圜	whiaii	whiaii
旯	lkuaaa	lkua
涪	mooeou	moo
莠	kvueiu	kvue
莴	sviaei	svia
赍	jfeiuo	jfeiu
阌	stuoou	stuo
嗍	biouea	bio
囵	lhuoua	lhu
巽	hraeaa	hrae
曷	wkuauo	wkua
柞	gdueie	gdue
榧	mdeiee	mdei
笾	nuauoa	nuau
簟	dueiai	duei
裰	dpaoao	dpao
跎	vqooau	vqoo
枋	mdoeau	mdo
绔	cceuoe	cceu
讵	jfeaea	jfea
逖	vnuauo	vnua
镒	kaoueu	kaou
餮	vbeuao	vbeu
骓	gpuioe	gpui
魃	nleuao	nleua
乜	taaaaa	taaa
瑭	vroeua	vro
踅	hqeieu	hqei
鄢	kxeiei	kxei
荛	sveaue	svea
蟛	yeeiei	yee
馓	bbeiie	bbe
鳟	czouei	czou
姹	zmooau	zmoo
忪	bwuoao	bwuoa
桉	pdooaa	pdoo
氘	dcuiii	dcui
氪	cceiia	ccei
纰	yceaua	ycea
阍	wtuaea	wtua
傈	ljeiai	ljeiai
垅	lleuau	lleu
娉	ymiaei	ymi
旮	rkuaia	rkuai
汊	zoaooo	zoaoo
纡	kceeii	kceei
缟	rcoeia	rco
镢	jaeuou	jaeu
堋	yluaee	ylua
庥	hbuiei	hbui
枥	ldeuau	ldeu
槊	fdouea	fdou
笮	cuueie	cuue
缁	ccaaai	cca
腭	psiaei	psiae
蔺	lvoiau	lvoi
跞	lquaiu	lquai
髂	qwooau	qwo
魍	sliaou	slia
鹕	wneiia	wne
吒	giueaa	giue
搿	rguoei	rgu
枳	gdiaeu	gdia
禳	shoeia	shoeia
舻	lrieae	lrie
蜍	zeuoee	zeuo
醚	twouei	twou
鏊	paeeie	pae
鹧	gnoeue	gnoe
珩	wruuie	wru
蒺	jvoeuo	jvoe
蜢	teaiei	teai
钹	naeuao	naeua
鬻	khouei	khou
卮	gueaaa	guea
垭	kleiio	kleii
瘘	lbouei	lbou
苄	nvoeio	nvoe
苕	fvauia	fvau
菀	svooau	svoo
袷	jpuoei	jpuo
跹	hqueio	hque
骠	npeiai	npei
磬	qteiea	qteie
笸	yueiae	yue
缶	myiiii	myi
鸷	gneieu	gnei
牦	txueea	txue
琮	prooae	proo
砩	mtaeau	mta
纨	scuaoo	scu
芰	jveiao	jvei
蕲	qvouia	qvo
蠲	jraiie	jrai
郓	kxoaea	kxo
锒	laoaee	laoa
锕	paaiei	paa
阆	ltoaee	ltoa
妯	gmiaei	gmia
舢	friaee	fria
趸	dqeaui	dqea
驷	bpiaua	bpi
鹩	lneuoo	lneu
嗉	bieeie	biee
笊	guuuio	guuu
芫	kveeua	kveeu
蠊	leoeuo	leoeu
枇	ydeaua	ydea
浯	soeiae	soeia
焱	kyouuo	kyouu
莸	kvuaue	kvuau
阃	ctiaei	cti
饴	kbaaoi	kbaa
擤	hguiae	hguia
柢	dduaea	ddu
醢	wweuia	wweui
铆	tauaua	tauau
呲	piieie	piie
堀	claeua	claeu
崾	kqeiai	kqei
帙	gzueeu	gzue
溆	houoee	houoee
潴	gouaue	goua
牖	kcoaeu	kcoa
硪	stueie	stue
碓	dtuioe	dtui
鬣	lquaaa	lquaa
鹆	knuouo	knuou
僳	bjeiai	bjei
幂	tpiaee	tpiae
桁	wduuie	wduu
獐	gkoeou	gkoe
疝	fbiaii	fbia
箝	queiee	quei
蛱	jeeoue	jeeo
诎	qfaiia	qfai
郴	zxeiuo	zxei
鳏	rziaii	rzia
呦	kiaaoa	kiaaoa
嗌	pioueu	piou
囹	lhuooa	lhuo
揶	kgeiie	kgei
脲	xsaeui	xsa
茴	wviaia	wvi
螈	keeuui	keeu
痼	rbiaei	rbi
胨	dseaiu	dsea
膈	rseiae	rseia
贽	gfeieu	gfei
赅	rfoeau	rfoe
锑	vaouae	vao
镊	xaeiie	xae
鳊	nzoaeu	nzoa
峄	kqaoee	kqao
桡	sdeaue	sdea
苤	yveuio	yveu
雎	jeiaee	jeiae
鞫	jkuaoe	jkuao
鲋	mzuiei	mzui
鼬	kriaei	kria
昀	kkuaoe	kkua
熘	lyuaoa	lyuao
獯	hkueia	hkue
疖	jbaiii	jbai
痍	kbeaea	kbeae
蟊	teaoai	teao
鞴	nkeiie	nkei
乇	vueaaa	vuea
侪	zjoeuo	zjoe
嵴	jqoeuo	jqoeuo
栀	gduuea	gduu
槲	wduaua	wdua
炝	qyuoaa	qyuo
炷	gyoeei	gyo
硐	dtiaei	dtiae
羸	lsoeai	lsoea
裾	jpaeue	jpae
锸	zaueiu	zaue
鹂	lneiao	lnei
佰	njeuia	njeu
僦	jjoeia	jjoei
哔	nieaua	nieau
屙	pqaiei	pqa
掾	kgaaeu	kgaa
旆	ygueei	ygue
牯	rxeiia	rxei
珐	mreiea	mre
钪	caoeua	cao
仟	qjueii	qjue
圮	ylaeaa	ylae
崃	lqeoue	lqeo
廪	lboeia	lboe
擘	ngaeui	ngaeu
笱	ruuaia	ruua
芟	fvuaao	fvuaa
跗	mquiei	mqu
鲅	nzeuao	nzeu
匏	yieeau	yiee
嗾	bioeau	bioe
圄	kheiae	khei
彀	rheieo	rheie
硷	jtuoeo	jtuo
苎	gvooae	gvoo
勐	twaiei	twa
卣	koiaae	koiaa
愍	twaeae	twae
掴	rgiaee	rgia
浞	goiaei	goiaei
涑	boeiae	boei
玳	druiea	dru
畛	gbuouu	gbuo
粳	jmeiae	jmeiae
赧	xzaiao	xza
刖	ksiiii	ksii
擀	rgeiia	rgeii
椴	dduiee	ddui
湫	joueiu	joue
箧	queeou	quee
貉	wjuaoi	wjua
逦	lneiao	lneia
铄	fauaiu	faua
鲮	lzeieu	lzei
啖	diouuo	diou
悭	qwiiao	qwii
愀	qwueiu	qwuei
朐	qsuaia	qsua
畈	mbuuao	mbuu
茱	gvueei	gvue
蛘	keouee	keou
訇	wtoeee	wtoe
鹨	lnaoea	lnao
佶	jjeiei	jjeie
凼	dhiauo	dhi
晟	zkeuaa	zkeua
缃	hceiuo	hceiuo
苴	jviaee	jviaee
颛	gziaie	gzia
鲱	mzieee	mzie
佤	sjeaao	sjea
厍	fceaei	fcea
徉	ktouee	ktou
氡	dcuaoo	dcua
洙	goueei	goue
癯	qbiaee	qbia
胗	gsuouu	gsuo
锆	raueie	raue
鞒	qkueuo	qkue
勰	hwauau	hwa
繇	kcuoou	kcuo
螭	zeoeuo	zeoe
钺	kaeaau	kaea
嵬	squiae	squi
瘿	kbiauo	kbia
肟	sseeaa	sse
肫	gseaia	gseai
轸	gkuouu	gkuo
仞	sjauoo	sjau
奁	lieuoa	lieuoa
宄	rpuaaa	rpu
樗	zdeoai	zdeo
熳	tyiaee	tyi
睇	dyouae	dyou
蝼	leouei	leou
跆	vqaoia	vqa
轳	lkieae	lkie
钼	taiaee	tai
鲰	czeiie	cze
榇	zdoeou	zdoe
薜	nvaeui	nvae
裥	jpoiai	jpo
诶	pfaoue	pfao
铧	wauiua	wau
寤	spaieu	spai
帑	vzauea	vza
怄	pweuoa	pweu
矬	pauouo	pauou
硗	qteaue	qtea
碡	dteeie	dtee
糅	smaoai	smaoa
缗	tcaeae	tcae
虺	weeuai	weeu
镧	laoiae	laoi
雠	zeoaui	zeoa
鸱	znuaea	znu
啁	giuaei	giua
埙	hliaei	hliae
悒	kwiaea	kwiaea
犍	jxaeee	jxaee
硌	rtuaoi	rtua
艉	sraeuu	sra
虿	zeeaui	zeea
蛑	teaoue	teaou
锩	jaouee	jaou
咴	wieuou	wieuo
筮	fueiuo	fuei
糁	bmaoeu	bmao
肄	kmuaue	kmua
艏	froueu	fro
鼍	vieiee	vieie
劢	tweaua	twea
砻	lfeuia	lfeu
籴	dmuoou	dmuo
蜮	keeiae	keeia
骜	ppeeie	ppee
黢	qlaouo	qla
龀	zuuaaa	zuua
畚	nleuoi	nleuo
稞	chiaee	chiaee
耪	yxoeou	yxoe
觳	wheieo	whei
鬯	zhuooo	zhuo
鲲	cziaee	czia
鹁	nneioa	nneio
娆	smeaue	smea
捌	ngiaea	ngia
柘	gdeuia	gdeui
獬	hkuaua	hkuau
篪	zuuuie	zuuu
菔	mvuaee	mvua
伥	zjueao	zjue
孬	xeuioa	xeu
滟	koeeei	koeee
狎	hkiaee	hkia
磔	gtuaoe	gtua
綦	qkaaoi	qkaa
聃	dxiaie	dxi
谇	bfoeuo	bfoe
谰	lfoiae	lfoia
遒	qnouei	qno
鄄	jxeiai	jxei
闫	kteeee	ktee
鲡	lzeiao	lzeia
齑	jfieee	jfie
泠	louooa	louoo
砗	zteaei	ztea
蔻	cvooae	cvo
钕	xaauee	xaau
镫	daaouu	daao
佥	qjeoou	qjeo
嶝	dqaouu	dqao
煅	dyuiee	dyui
煸	nyoaeu	nyoa
罘	meeuio	meeu
胂	fsiaee	fsia
菹	jvooei	jvooe
螯	peeeie	peee
躅	gqiaii	gqia
鲠	rzeiae	rzei
哞	tiaoue	tiao
坨	vlooau	vloo
徜	ztioui	zti
慊	qwouea	qwou
洳	soauei	soau
渑	toiaei	toiaei
灞	nooooo	noooo
盍	wseiea	wsei
縻	tcoeue	tco
羰	vsiaie	vsiai
菽	fvieei	fviee
萘	xveuoe	xveu
褫	zpuuie	zpu
踯	gqouee	gqou
钋	yaiooo	yai
鸫	dneaiu	dnea
俅	qjeioe	qjei
怛	dwiaee	dwiae
洮	vouoea	vouoe
罴	yeeiea	yeei
胼	ysouee	ysou
芤	cvaiea	cvai
镛	kaoeua	kaoeu
隳	wwaieu	wwai
啉	lieiuo	lieiu
噌	piouia	pioui
嫱	qmeiou	qmeio
焐	syeiae	syei
绲	rciaee	rcia
膻	fsoeia	fsoe
芊	qvueii	qvuei
亓	qvuiii	qvui
倮	ljiaee	ljiaee
嘞	lieiie	lieiie
缒	gcuiae	gcui
莼	zvaaee	zva
蘅	wvuuiu	wvuu
镆	taeiii	taei
伧	pjuoaa	pjuo
唳	lioaeu	lioae
檩	ldoeia	ldoeia
澍	foeiei	foeie
荏	svuiue	svui
蘖	xvuiae	xvui
蚬	heiaua	heiau
韫	kqiaee	kqi
骱	jwuoui	jwuo
鸶	bnaaaa	bna
嘏	rliaea	rliae
垡	mluiea	mlui
怙	wweiia	wweiia
焯	zyieia	zyie
羧	bsaouo	bsa
腚	dsooae	dsoo
鼙	ylaeou	ylaeo
亳	nfaeoa	nfa
倥	cjooau	cjoo
昴	tkuaua	tkua
枵	hdiaee	hdiae
粜	vmaiia	vma
舨	nruuao	nruu
艽	jvuaaa	jvuaa
荠	jvoeuo	jvoeu
醣	vwoeua	vwoe
魈	hlioui	hlio
杓	nduaoo	ndua
楦	hdooae	hdoo
楸	qdueiu	qduei
珲	wroaea	wroa
甙	deieea	deie
疃	vboeou	vboe
茔	kleiio	kleiio
蛏	zeaoei	zeao
蠛	teeiii	teeiii
髌	nwooau	nwoo
嬖	nmaeui	nmae
笄	jueeui	jueeu
蜣	qeouee	qeou
诼	gfeuau	gfeua
跣	hqueie	hquei
钣	nauuao	nauu
喾	csueie	csue
戆	gwoeou	gwo
蜉	meuoou	meuo
铍	yaauia	yaa
岵	wqeiia	wqe
瓴	lruooa	lruo
肷	qsuauo	qsuau
薹	vveiei	vve
陉	hxaoei	hxao
怫	mwaeau	mwa
窀	gseaia	gseaia
缯	ccouia	ccou
荽	bvuoou	bvu
钭	daooei	daooe
倬	gjieia	gjie
帔	yzauia	yza
摭	ggoeue	ggoeu
楝	ldeiao	ldei
痱	mbieee	mbie
蚶	weeiie	weeiie
螬	peeiae	peei
髑	dwiaii	dwiai
殛	jpaiia	jpai
狷	jkiaei	jkiaei
粝	lmeuea	lmeu
萋	qveaee	qvea
葭	jvaeie	jvaei
衽	spueie	spue
裉	cpaeea	cpa
鳢	lziaei	lziae
鼗	vueauo	vueau
傧	njooau	njoo
喁	kiiaee	kiiaee
嫘	lmiaei	lmia
愦	cwiaei	cwiae
罟	reeiia	reeii
蝽	zeeeeu	zeee
裼	vpiaee	vpia
钌	laaiii	laa
哌	yiuuua	yiuu
墉	kloeua	kloeu
廛	zbiaee	zbia
粢	cmoeua	cmoeu
衿	jpuooa	jpuoo
跫	qqeieu	qqeie
醵	jwieau	jwiea
鐾	naaeui	naa
锗	gaeieu	gaeie
堇	jveiae	jveia
婧	jmeeie	jmee
扦	qgueii	qguei
暌	ckeaou	ckeao
罱	leeiia	leeii
脘	ssooae	ssoo
蹰	zqeuei	zqeu
镞	caoeau	caoe
陟	gxieie	gxi
鳔	nzeiai	nzei
侔	tjaoue	tja
唿	wiuauu	wiuau
岿	cqiuae	cqiu
疴	pbeiae	pbeia
砹	pteiiu	pte
薨	wviaii	wvia
郾	kxeiae	kxeia
麸	mceeuo	mcee
偾	mjeiei	mjeie
呒	tieeua	tiee
拊	mguiei	mgui
撺	pgooau	pgoo
椁	rdoeia	rdoei
榱	pdoeia	pdoe
滁	zoaiuo	zoai
狯	ckuoee	ckuo
猢	wkeiia	wkeiia
璎	kriauo	kriau
眦	cyieie	cyie
罾	ceouia	ceo
裎	zpiaee	zpia
铳	zaoeao	zaoe
崞	rqoeia	rqo
缇	vciaee	vcia
蝣	keoeau	keoe
冼	hzueie	hzue
晷	rkuaoi	rkuao
狲	bkaiei	bkai
痧	fbooei	fbo
缱	qciaei	qci
萑	wvuioe	wvuio
儋	djuaeu	djua
帏	szeeai	sze
憷	zweiuo	zwei
狍	ykuaae	yku
疠	lbeauu	lbea
窨	hsoeou	hsoeo
绨	vcouae	vco
蕖	qvooee	qvoo
袼	rpuaoi	rpua
锛	naeuoe	naeuo
嵝	lqouei	lqoue
庀	ybuaaa	ybuaa
汜	boaeaa	boae
泶	hsiauo	hsiau
炅	jkouuo	jkou
煳	wyeiia	wyeii
瓠	wjeuoe	wjeu
窳	ksuuao	ksuu
蘩	mvueaa	mvue
虮	jeuaaa	jeua
蚰	keiaei	keiae
邰	vxaoia	vxa
捩	lgoaeu	lgoa
砀	dtauuu	dta
苊	pveuaa	pveu
莪	pvueie	pvue
螽	geuaoo	geua
蹉	pqouee	pqou
曛	hkueia	hkuei
槔	rduiae	rdui
犸	tkaaee	tkaa
蘼	tvueiu	tvuei
蛲	xeeaue	xee
衄	xhaiee	xhai
隹	geeeee	geee
鹾	phouee	pho
墀	zlaeui	zlae
泫	hooeaa	hooea
玢	nruoau	nruo
辊	rkaeee	rka
酐	rweeii	rwee
銎	qaeieu	qaei
噻	biooae	bioo
嚯	wieoai	wieo
堞	dleiie	dleii
尥	lvuaoo	lvua
嵛	kquoei	kquoe
猗	kkeuoe	kkeu
畀	nbuiii	nbuii
硖	hteoue	hteo
逑	qneioe	qnei
逯	lnaeei	lnae
偬	cjuauu	cjua
呖	lieuau	lieuau
塬	kleuui	kleu
嫒	pmuoou	pmuo
嬲	xmiaei	xmi
沆	wooeua	wooeu
溧	loeiai	loeia
窭	jsouei	jsou
缣	jcouea	jcoue
肭	xsiauo	xsi
谵	gfuaeu	gfuae
鄞	kxeiie	kxeii
鹈	vnouae	vnou
鹱	wneiiu	wnei
黧	llueiu	llu
仫	tjuaoo	tjua
喱	lieuia	lieui
曩	xkoeia	xkoe
朊	sseeua	ssee
泔	roeiie	roeiie
溘	coeiea	coei
秫	fheiuo	fhei
箪	duouia	duo
肀	kaeeii	kaee
蒌	lvouei	lvou
裣	lpuoeo	lpuoe
赀	cfieie	cfie
迕	snueei	snue
酃	lxeoai	lxeo
铋	naoaou	naoa
鳙	kzoeua	kzoeu
悱	mwieee	mwi
挹	kgiaea	kgiaea
捭	nguiae	ngui
盱	hyeeii	hyee
糇	wmuiae	wmui
胙	csueie	csuei
芑	qvaeaa	qvaea
钎	qaueii	qauei
鬟	wqiaii	wqia
崤	hquoeu	hquo
欹	kbeuoe	kbeu
澶	zooeia	zooei
甾	cbiaei	cbia
瞽	ryeiei	ryei
缡	lcoeuo	lcoe
钇	kaaaaa	kaaaa
铯	bauaai	bau
鞔	tkuaia	tkuai
鲚	jzoeuo	jzoeu
鹪	jnuioe	jnui
嘬	ziiaee	ziiae
庹	vbeiie	vbeii
渖	foooai	fooo
湔	joouei	joou
燹	hyeuau	hyeu
猊	xkuiea	xku
玎	dreiii	dre
籼	hmiaii	hmia
舾	hreiau	hreia
锊	lauoou	lauo
阊	ztiaee	ztia
岣	rquaia	rqua
幛	gzoeou	gzo
敫	jyuiae	jyui
樘	vdiouo	vdio
浼	touaia	tou
瑷	pruoou	pruo
甯	xpoaoo	xpo
癔	kboeou	kboeo
穸	hsuaoo	hsua
篦	nuuiau	nuui
葑	mveiee	mveie
蓼	lvaoea	lvao
蚍	yeeaua	yeea
褊	npoaeu	npoa
钔	taoiaa	taoi
钫	maoeau	mao
钯	naaiea	naai
铒	paeiie	paei
锼	bauiea	baui
锿	paoeia	paoe
麇	jhueiu	jhue
嵯	pqouee	pqoue
戗	qiuoaa	qiuoa
泮	yoouee	yoou
瀣	hoieua	hoie
皴	pvaouo	pva
睃	byaouo	bya
莩	mvuoou	mvuoo
轫	skauoo	skau
逭	wnooai	wnoo
遄	zniaie	znia
炱	vyaoia	vyao
篁	wuuiae	wuui
葚	sveiie	sveii
褰	qpooae	qpoo
醍	vwiaee	vwiaee
锱	caaaai	caa
戥	diiaee	diia
睥	yyuiae	yyui
筇	queiea	queie
辚	lkouei	lkou
驺	cpuaae	cpua
驽	xpauea	xpa
髀	nwuiae	nwui
鸺	hnuiei	hnui
哙	ciuoee	ciuoe
桤	qdiaia	qdi
楮	zdeieu	zdei
濞	nouiae	noui
炻	fyeuia	fyeu
疳	rbeiie	rbeii
眇	tyiuou	tyiu
砜	mtuauo	mtua
磙	rtoeuo	rto
迓	kneaiu	kneai
逄	ynuaoe	ynua
醭	nweiau	nweia
鳇	wzuiae	wzui
仡	rjueaa	rjue
唢	biioui	biio
栌	ldieae	ldie
殳	fhoooo	fhoo
獍	jkoeou	jkoeo
菘	bveiuo	bvei
醐	wweiia	wweiia
馇	zbeiuo	zbei
刿	rmiaiu	rmiai
垴	xloeuo	xlo
尕	rsauiu	rsa
搴	qgooae	qgoo
暝	tkoaia	tko
殄	vpuouu	vpu
湓	youoau	youoa
磴	dtaouu	dtao
祢	thuaiu	thuai
艚	preiae	prei
葜	qveeei	qvee
薅	wvauee	wvau
豉	faeiao	fae
锝	daiaee	daia
镅	taaieu	taai
氙	hciaii	hcia
煺	vyaeea	vyae
瓿	nroeou	nroeo
蟥	weeiie	weeiie
蹀	dqeiie	dqei
铑	laeieu	laei
黼	mlouia	mlou
杪	tdiuou	tdi
砬	ltoeou	ltoe
硭	tteiio	tte
肜	ssuuuu	ssu
膂	lsoeau	lsoeau
蒡	nvoeou	nvoeo
蒴	fvouea	fvou
踟	zqueeu	zque
酽	kweiio	kwei
鲷	dzuaei	dzua
哏	riaeea	riae
哿	rwiaee	rwi
旒	lgueoe	lgue
殍	ypuoou	ypuo
漯	loiaei	loiaei
猡	lkiaii	lkia
皤	ykuoue	ykuo
硇	xtuiau	xtu
藁	rvoeia	rvoe
锍	laoeao	laoea
鞲	rkeeii	rkee
喹	cieuoe	cieuo
姝	fmueei	fmue
橥	gduaue	gdua
溏	vooeua	vooeu
畋	vbueuo	vbue
窆	nsuoao	nsuo
茭	jvoeuo	jvoeuo
谂	ffuooa	ffuoo
镬	waeiiu	wae
髟	nquuuu	nquu
鲔	szeuia	szeu
鸲	qnuaia	qnua
吣	qioaoo	qioa
窬	ksuoei	ksuoe
缧	lciaei	lcia
羼	zqouee	zqou
赉	lfeoue	lfeo
镓	jaooae	jaoo
骘	gpaiie	gpai
孥	xhauea	xhaue
敉	tmueuo	tmue
涠	soiaee	soiaee
溲	bouiea	bou
璩	qrieau	qri
筌	quuoee	quuo
邳	yxeuio	yxe
鸸	pneuia	pneui
垓	rloeau	rloe
甓	yraeui	yra
脔	lfiiuo	lfii
艟	zroeou	zroe
苒	sviaie	sviai
荸	nveioa	nvei
锪	wauauu	waua
镄	maaeau	maa
彘	grueeu	grue
旄	tgueue	tgu
檠	qdeiiu	qdeii
祆	hheeuo	hhee
胩	csieei	csie
丌	jeuiii	jeui
丨	riiiii	riii
丬	qsiiii	qsi
丶	gooooo	gooo
丿	yuuuuu	yuuu
亍	zviiii	zvii
亠	vfeeee	vfee
亻	sjiiii	sjii
仂	ljauuu	lja
仉	gjuaaa	gjua
仝	vjeiee	vjei
仳	yjeaua	yjea
仵	sjueei	sjuee
伛	kjeuoa	kjeuoa
佧	cjieei	cjie
佴	pjeiie	pjei
佾	kjuoia	kjuo
侉	cjeuoe	cjeuo
侑	kjeuia	kjeuia
俜	yjiaei	yjia
傺	zjuaoo	zjuao
僬	jjuioe	jjuio
儇	hjiaii	hjiai
兕	bfiaia	bfia
冁	zruiae	zru
冂	jhaaaa	jhaa
冖	tpaaaa	tpaa
冫	nzeeee	nzee
冱	wzeaae	wze
凵	qhiiii	qhii
刂	dmiiii	dmii
刭	jmaoei	jmao
刳	cmeuoe	cmeu
剀	cmiaia	cmi
剞	jmeuoe	jmeu
剡	fmouuo	fmou
劁	qmuioe	qmu
劂	jmeuou	jmeuo
劐	wmeiiu	wmei
劓	kxiiii	kxii
勹	ntaaaa	ntaa
匚	mhaaaa	mhaa
卩	jxiiii	jxii
卺	jaauoe	jaau
厶	bloooo	blooo
叻	liauuu	liau
吖	kiouii	kiou
吲	kiaeai	kiae
呙	riiauo	riiau
哓	hieaue	hiea
哕	kiiaiu	kiiai
哚	diuaei	diuae
哜	jioeuo	jioe
哳	gieieu	gieie
唛	tieeie	tieei
唣	ciuiae	ciui
唪	mieeeu	mieee
唼	fioeou	fioe
喈	jieaua	jiea
噍	jiuioe	jiui
嚆	wieiio	wieiio
囗	sheeee	shee
囝	jhaiee	jhaie
圉	kheieo	kheie
圊	qheeie	qhee
圬	sleeaa	slee
圯	klaeaa	klaea
圹	cloeuu	cloeu
坌	nluoau	nluo
坜	lleuau	lleua
坩	rleiie	rleii
坫	dlieia	dlie
坭	xlaeuu	xla
坶	tlaaoe	tlaa
坻	zluaea	zlu
坼	zluuei	zluu
垆	llieae	lli
垌	dliaei	dlia
垤	dleaoe	dlea
垧	fluiai	flu
垲	cliaia	cliai
垸	klooae	kloo
埏	fluiea	flui
埒	lluoou	lluo
埕	zliaee	zli
埘	fliaee	flia
埚	rliaei	rliaei
埝	xluooa	xlu
埤	yluiae	ylui
埭	dlaeei	dlae
埯	pleuoi	pleu
埴	gleiia	glei
埸	kliaee	klia
堍	vluaia	vlua
堙	kleiai	kleiai
堠	wluiae	wlu
塄	lliaee	llia
塍	zsouee	zso
塥	rleiae	rleia
墁	tliaee	tlia
墚	llooea	lloo
墼	jleiae	jlei
夂	gloooo	gloo
夼	ciuiii	ciuii
妁	fmuaoo	fmuao
妣	nmeaua	nmea
妤	kmaoai	kma
娈	lmoeii	lmoei
媵	ksouee	ksou
嫜	gmoeou	gmoe
嫫	tmeiii	tmeii
孑	jhaiee	jhaiee
孓	jhaioo	jhaio
宀	tpaaaa	tpaaa
尜	rseuoi	rseuo
尢	kvaaaa	kvaaa
尻	cquaaa	cqu
屣	hquuii	hquu
屦	jquuio	jquui
屮	zviiii	zviii
屺	qqaeaa	qqaea
岈	kqeaiu	kqeai
岍	qqeeui	qqee
岙	pqueuo	pqueu
岜	nqaiea	nqai
岽	dqeaiu	dqeai
崦	kqeuoi	kqeuo
嵫	cqouea	cqou
嶷	kquaue	kqua
巛	zbaaaa	zba
巯	qiaoei	qiao
帱	zzeeeu	zzee
帻	czeeie	czee
幞	mziiou	mzii
庳	nbuiae	nbuia
廑	jbeiie	jbei
廒	pbeeie	pbee
廨	hbuaia	hbuaia
廴	knoooo	kno
廾	rviiii	rviii
弪	jhaoei	jhao
彐	jreeee	jreee
彖	vruauu	vru
彡	fguuuu	fguu
彳	ztiiii	ztii
徂	ptiaee	pti
徼	jtuiae	jtui
忄	hwiiii	hwii
忉	dwauuu	dwau
忭	nwoeio	nwoe
忮	gweiao	gwei
怃	sweeua	swee
怊	zwauia	zwa
怍	cwueie	cwuei
怿	kwaoee	kwaoe
恝	jweeei	jwee
恧	xweuia	xweu
悃	cwiaei	cwiaei
悛	qwaouo	qwa
悝	cwiaee	cwiaee
悫	qweieo	qweie
惝	zwioui	zwio
慝	vweeii	vweei
憝	dwoeia	dwoei
戋	jeeauo	jeea
戢	jiiaee	jiia
戤	riauao	riau
戽	wbooei	wbo
扃	jbiaia	jbiai
扌	fgeeee	fgeee
拶	cgaaau	cgaa
挢	jgueuo	jgueuo
捃	jgaeeu	jgaee
掊	ygoeou	ygoe
掎	jgeuoe	jgeuo
掭	vgeeuo	vgeeu
揎	hgooae	hgo
揞	pgoeou	pgoe
揠	kgeiae	kgeia
揲	dgeiie	dgei
揸	ggeiuo	ggeiu
搋	zguuie	zguui
搌	ggaeue	ggaeu
搛	jgouea	jgou
搠	fgouea	fgou
搦	xgaeao	xgaea
摅	fgieau	fgie
撄	kgiauo	kgiau
撖	wgaeii	wga
撙	cgouei	cgou
擐	wgiaii	wgia
擗	ygaeui	ygae
攉	wgeoai	wgeo
攮	xgoaia	xgoa
攴	ykoooo	yko
攵	yyoooo	yyoo
旰	rkeeii	rkeei
昃	ckeuuo	ckeu
昝	ckuaoi	ckua
晡	nkeiae	nkeia
暾	vkoeia	vko
杌	sdeuaa	sdeua
杩	tdaaee	tdaa
枘	sdiauo	sdi
枧	jdiaua	jdiau
枨	zdueao	zduea
柁	ddooau	ddo
柃	lduooa	lduo
柒	qdooee	qdoo
柙	hdiaee	hdiaee
柝	vduuei	vduu
柰	xdeeiu	xdee
柽	zdaoei	zdaoe
栊	ldeuau	ldeua
栝	rdueii	rduei
栲	cdeieu	cdeieu
栳	ldeieu	ldeie
桄	rdioue	rdio
桊	jdouee	jdou
桕	jduiea	jdui
桫	bdooei	bdo
桴	mduoou	mduo
桷	jduaua	jduau
梃	vdueie	vdue
棰	zdueie	zduei
棹	gdieia	gdie
棼	mdeiuo	mdeiu
椐	jdaeue	jdaeu
椟	ddeiao	ddei
椠	qdeaie	qdea
椹	fdeiie	fdei
楗	jdaeee	jdaeee
楱	cdeeeu	cdeee
榀	ydiaei	ydi
榍	hdaeui	hdae
槠	gdoaei	gdoae
樨	hdaeui	hdaeu
橼	kdaaea	kdaa
檎	qduooe	qduo
檑	ldeoai	ldeo
檗	ndaeui	nda
檫	zdooau	zdoo
欷	hbuoeu	hbuo
歃	fbueiu	fbue
殂	ppiaee	ppi
殪	kpeieo	kpeie
毪	tuaoue	tua
毳	puueea	puu
毵	buaoeu	buao
毹	fuuoei	fuuo
毽	juaeee	juaee
氆	yuouei	yuo
氇	luuaia	luua
氍	quiaee	quia
氕	ycuuuu	ycuu
氵	foeeee	foee
氽	vjiauo	vjia
汆	pouoia	pouoi
汔	qoueaa	qoue
沔	toeiaa	toeia
沩	soouao	soou
沭	foeiuo	foeiu
沲	voueai	voue
泐	loaiau	loai
泖	touaua	toua
泺	louaiu	louai
洇	koiaeu	koiae
洎	jouiae	joui
洚	jouaoe	jouao
洧	soeuia	soeu
洫	houiai	houiai
浈	goieia	goiei
浍	wouoee	wouo
淠	yoiaei	yoia
渫	hoeiie	hoeiie
溱	qoeeeu	qoeee
溷	woiaeu	woiaeu
溻	voiaee	voiae
溽	soeuee	soeue
滏	mououo	mouou
滗	noueou	noue
滠	foeiie	foeii
滹	woieau	woie
漤	loeiuo	loeiu
漭	toeiie	toeii
漶	woiaei	woiaei
潋	louoeo	louoe
潲	foueiu	fou
澉	roaeii	roae
澌	boeiie	boeii
瀵	moouei	moou
瀹	kouoei	kouoei
灬	nyoooo	nyoo
烀	wyuoue	wyuou
燠	kyuiao	kyuia
爝	jyuoou	jyuo
爨	pyuiee	pyui
爿	yhuuuu	yhuu
牮	jxuiea	jxui
牾	sxeiae	sxei
牿	rxueie	rxue
犋	jxiaee	jxia
犏	yxoaeu	yxoa
犭	qkuuuu	qkuu
犰	qkuaaa	qkua
犴	pkeeii	pkeei
狁	kkaoua	kkaou
狃	xkaiee	xkai
狨	skeeua	skee
狳	kkuoee	kkuoe
狴	nkeaua	nkea
狺	kkoeee	kkoee
猁	lkueiu	lkue
猃	hkuoeo	hkuo
猞	fkuoee	fkuo
猱	xkaoai	xkao
猸	tkaieu	tkai
猹	zkeiuo	zkei
獒	pkeeie	pkeeie
玟	sroeuo	sroe
珉	traeae	tra
珙	rreiie	rreii
珧	kruoea	kruoe
琚	jraeue	jrae
瑗	kruoou	kruoou
璁	pruiau	prui
璺	sruiee	srui
瓞	djueeu	djue
甍	tviaii	tviaii
甏	nreiei	nre
畎	qbeuoo	qbeu
疋	ydoooo	ydo
疒	xbeeee	xbee
疔	dbeiii	dbeii
疬	lbeuau	lbeua
疰	gboeei	gboe
痃	hboeaa	hboe
痄	gbueie	gbue
痖	kbeiio	kbei
痦	sbeiae	sbei
瘃	gbeuau	gbeu
瘅	dbouia	dbo
瘊	wbuiae	wbui
瘌	lbeiae	lbeia
瘐	kbuiea	kbuiea
瘕	jbaeie	jbae
瘗	kbeoue	kbeo
瘥	zbouee	zbou
瘭	nbeiai	nbeia
瘰	lbiaei	lbi
瘳	zbaoea	zbao
瘵	gbuaoo	gbua
瘼	tbeiii	tbei
癀	wbeiie	wbe
癃	lbaiua	lbai
癍	nbeeie	nbee
皲	jvoaea	jvoa
眄	tyeiaa	tyeia
眍	cyeuoa	cyeu
眙	kyaoia	kyao
眚	fyueei	fyue
眢	kyuaoa	kyua
眭	byeiee	bye
眵	zyuaou	zyuao
睚	kyeuei	kyeu
瞀	tyaoai	tyaoa
瞍	byuiea	byui
瞢	tviaii	tviaii
瞵	lyouei	lyou
矧	faaeai	faa
砑	kteaiu	ktea
砘	dteaia	dtea
砟	gtueie	gtue
砼	vtuoei	vtu
碥	ntoaeu	ntoa
碲	dtoeou	dtoe
碹	htooae	hto
磉	bteaoa	bte
磲	qtooee	qtoo
礅	dtoeia	dtoei
礓	jteiae	jtei
礞	tteiio	ttei
礤	ptiiua	ptii
礻	fhoooo	fhooo
祓	mheuao	mhe
祧	vhuoea	vhuo
禊	hheeei	hheee
禚	ghouee	ghou
秕	nheaua	nhea
秭	chuaiu	chua
稂	lhoaee	lhoa
稃	mhuoou	mhuo
稆	lhiaei	lhi
筅	huueie	huue
筘	cueiei	cuei
筚	nueaua	nuea
筢	yueiea	yuei
筲	fuioui	fuio
筻	rueiae	rueia
箅	nuiaei	nui
箐	queeie	queei
箜	cuooau	cuoo
箢	kuooau	kuoo
箦	cueeie	cuee
箨	vueiea	vuei
箬	sueiie	suei
篌	wuuiae	wuuia
篚	mueiee	mue
篥	lueiai	lueia
篼	duuiae	duui
簋	ruaeea	rua
簏	luoeua	luoeu
簖	duouei	duou
籀	gueieu	gueieu
粞	hmeiau	hmeia
糈	hmaieu	hmai
糌	cmuaoi	cmua
糍	pmouea	pmou
糗	qmuiae	qmui
糨	jmaeai	jmae
糸	tcoooo	tcoo
絷	gceieu	gceie
綮	qcoaeu	qcoa
纛	dceeie	dcee
纟	bceeee	bcee
纩	ccoeuu	ccoe
绁	hceiie	hceii
绂	mceuao	mceu
绋	mcaeau	mcae
绐	dcaoia	dca
绗	wcuuie	wcuu
绠	rceiae	rcei
绡	hcioui	hcio
缋	wciaei	wcia
缌	bciaei	bci
缍	dcueie	dcue
缏	ncuiei	ncui
缑	rcuiae	rcu
缲	qciaei	qcia
缳	wciaii	wciai
缵	ccueie	ccue
罨	keeuoi	keeuo
羝	dsuaea	dsu
翥	gzeieu	gzei
翮	wzeiae	wzei
耋	dleaoe	dleao
耒	lxoooo	lxoo
耔	cxaiee	cxa
耖	zxiuou	zxiu
耜	bxoiae	bxoi
耠	wxuoei	wxuo
耢	lxeiio	lxeii
耥	vxioui	vxi
耧	lxouei	lxou
耩	jxeeii	jxee
耱	txoeue	txoe
耵	dxeiii	dxeii
聍	xxooae	xxo
聱	pxeeie	pxee
胬	xmaoia	xmaoi
胲	wsoeau	wsoe
脎	bsuoei	bsu
脒	tsouei	tsou
脞	psuouo	psuo
脬	ysuoou	ysuo
脶	lsiaei	lsia
腈	jseeie	jseei
腙	csooae	csoo
腠	pseeeu	pse
腧	fsuoei	fsuo
腩	xseiia	xsei
腽	ssiaee	ssia
膣	gsooau	gsoo
膦	lseoue	lseo
膪	zsoeou	zsoe
臌	rseiei	rseie
舁	kkeuii	kkeui
舄	hkuaoo	hkuao
舡	zreiee	zre
舣	krouoo	krouo
舭	nreaua	nrea
舯	griaei	gri
舳	griaei	gria
舴	crueie	crue
艋	traiei	trai
艨	treiio	tre
艴	mhuiua	mhui
艹	pviiii	pvii
芈	tlieie	tlie
芘	yveaua	yvea
芴	svuauu	svuau
苈	lveuau	lveua
苘	qviaia	qvia
苠	tvaeae	tvae
茆	tvuaua	tvuau
茇	nveuao	nveu
茈	pvieie	pvie
茌	zvuiei	zvui
茕	qvoaae	qvoa
茚	kvuaea	kvuae
茛	rvaeea	rvae
茳	jvooee	jvooee
茺	zvoeao	zvo
茼	vviaei	vvi
荇	hvuuie	hvuu
荑	vveaea	vvea
荜	nveaua	nvea
荦	lxeiio	lxeiio
荬	tvaooe	tvao
荮	gvaaee	gvaa
莛	vvueie	vvue
莨	lvoaee	lvoa
莰	cveieu	cveie
莳	fviaee	fvia
莶	hvuoeo	hvuo
菝	nveiee	nveie
菡	wvaioe	wvai
菥	hveiuo	hve
菪	dvooae	dvoo
菰	rvaieu	rvai
萁	qveiie	qvei
萆	nvuiae	nvuiae
萏	dvuaue	dvuau
萜	vviaii	vvia
葙	hveiuo	hvei
葳	sveuea	sveue
葶	vvoeia	vvo
葸	hviaei	hvia
蒇	zveuia	zveu
蒈	cveaua	cvea
蒉	cviaei	cvia
蒎	yvooeu	yvooe
蒗	lvooeo	lvoo
蒹	jvouea	jvou
蒽	pviaeu	pviae
蓁	gveeeu	gvee
蓊	svuoao	svuo
蓍	fveieu	fve
蓐	sveuee	sveuee
蓠	lvoeuo	lvoe
蓣	kvaoai	kvaoa
蓥	kaeiio	kaei
蓰	hvuuii	hvuui
蔌	bveiae	bveia
蔟	pvoeau	pvoea
蔸	dvuiae	dvui
蔹	lvuoeo	lvuoe
蕈	hveiai	hveia
蕞	cviaee	cviae
蕤	sveuau	sveua
蕹	svoeaa	svoe
蕺	jviaee	jviaee
蕻	wveiee	wveie
薤	hveuao	hveu
薷	sveoai	sveo
蘧	qvieau	qvie
虍	wsaaaa	wsa
蚵	weeiae	weeiae
蚺	seiaie	seiai
蛸	feioui	feio
蜞	qeeiie	qeeii
蜩	veuaei	veua
蜱	yeuiae	yeui
蜾	reiaee	reiaee
蝓	keuoei	keuo
蝤	qeouei	qeoue
蝥	teaoai	teaoa
蝰	ceeuoe	cee
蝻	xeeiia	xeei
蝾	seeiio	seeii
螋	beuiea	beui
螓	qeeeeu	qeee
螗	veoeua	veoe
螵	yeeiai	yeeia
蟓	heuaia	heua
蠃	leoeai	leoea
衤	kpoooo	kpooo
裒	yfuiea	yfui
褙	npieeu	npie
襞	npaeui	npa
襦	speoai	speo
襻	ypeiuo	ype
觇	zgieia	zgiei
觋	hgeiuo	hgeiu
觌	dgeiao	dgeia
觏	rgeeii	rgee
觖	jvaeuo	jvaeu
觚	rvuuao	rvuu
觜	cvieie	cvie
觫	bveiae	bveiae
訾	cfieie	cfiei
謦	qfeiea	qfe
讠	kfaaaa	kfaaa
谫	jfouei	jfou
谮	cfeaua	cfea
谳	kfeiia	kfeii
豇	jaeiee	jaei
豳	nqeuau	nqeu
豸	gjuuuu	gjuu
貅	hjuiei	hjui
貊	tjeuia	tjeu
貔	yjuiau	yjui
貘	tjiiia	tjii
贳	ffeiie	ffeii
贶	cfiaeu	cfiaeu
赆	jfaeuo	jfaeu
赇	qfeioe	qfei
赕	dfouuo	dfou
赙	mfeiae	mfei
趑	cuoeua	cuoe
趱	cuueie	cuuei
趵	nquaoo	nquao
趼	jqeeui	jqeeu
跖	gqeuia	gqeu
跬	cqeiee	cqeie
跽	jqaeao	jqaea
踣	nqoeou	nqoe
踬	gquuei	gquu
踺	jqaeee	jqaee
蹁	yqoaeu	yqoa
蹯	mquoue	mquo
躐	lqaaai	lqa
躔	zqoeui	zqoe
躜	cqueie	cque
躞	hqoeee	hqo
軎	skiaee	skiae
轵	gkiaeu	gkia
轷	wkuoue	wkuou
轹	lkuaiu	lkuai
轺	kkauia	kkaui
轾	gkeaoe	gkea
辁	qkuoee	qkuo
辂	lkuaoi	lkuao
辋	skaoue	skao
辶	znoooo	znoo
迮	cnueie	cnu
遘	rneeii	rnee
邗	wxeeia	wxee
邡	mgaiii	mgai
邴	nxeiau	nxei
邶	nxieeu	nxie
邾	gxueei	gxu
郄	qxuoeu	qxuo
郇	wxuaia	wxua
郐	cxuoee	cxuo
郗	hxuoeu	hxuo
郜	rxueie	rxuei
郫	yxuiae	yxui
鄹	cxeiie	cxe
酎	gweioo	gweio
酏	kwaiaa	kwai
酞	vweuoo	vweu
酡	vwooau	vwoo
酤	rweiia	rweii
酲	zwiaee	zwia
酴	vwuoee	vwuo
酹	lwuoou	lwuo
酾	fweiao	fweia
醅	ywoeou	ywo
醌	cwiaee	cwiaee
醑	hwaieu	hwai
钅	jaaaaa	jaaaa
钆	raaaaa	raa
钐	fauuuu	fauu
钬	waouuo	waou
钲	gaeiei	gaeiei
钶	caeiae	caei
钷	yaeiae	yae
钸	naeuia	naeui
钽	vaiaee	vaiae
铈	faoeia	faoe
铊	vaooau	vaoo
铌	xaaeuu	xaae
铕	kaeuia	kaeu
铖	zaeuaa	zae
铗	jaeoue	jaeo
铘	kaeaiu	kaeai
铙	xaeaue	xaea
铞	daiaei	daiae
铟	kaiaeu	kaia
铥	daueie	dauei
铪	wauoei	wauo
铫	kauoea	kauo
铴	vaooea	vaooe
铷	saauei	saa
铹	laeiio	laeii
铼	laeoue	laeou
铽	vaeoao	vaeo
锇	paueie	paue
锎	caoiae	caoi
锓	qaaeeo	qaa
锔	jaaeua	jaaeu
锖	qaeeie	qaeei
锘	xaeiie	xaei
锞	caiaee	caiaee
锫	yaoeou	yao
锬	vaouuo	vaou
锾	wauoou	wauoo
镎	xauoei	xauo
镔	naooau	naoo
镗	vaiouo	vaio
镘	taiaee	taia
镙	laiaei	laiaei
镝	daaoeo	daaoe
镟	haoeau	haoeau
镡	haeiai	hae
镤	yaiiou	yaii
镥	lauaia	lauai
镦	daoeia	daoe
镨	yaouei	yaou
镩	paooau	paoo
镪	qaaeai	qaae
镱	kaoeou	kaoeo
镲	zaooau	zaoo
阚	ctaeii	cta
阝	mxiiii	mxi
阢	sxeuaa	sxeu
阼	cxueie	cxue
阽	dxieia	dxie
陔	rxoeau	rxoe
陧	xxiaee	xxia
陬	cxeiie	cxei
陴	yxuiae	yxuia
隈	sxiaei	sxi
隰	hxiaee	hxia
雩	kqeeaa	kqee
霈	yqooee	yqoo
霪	kqooeu	kqo
顸	wzeeie	wzee
颃	wzoeua	wzo
颟	tzeiie	tze
颡	bzaoao	bza
颥	szeoai	szeo
飑	nxuaae	nxua
饣	fbaaaa	fbaa
馘	rreuia	rreui
驵	cpiaee	cpi
骀	vpaoia	vpao
骐	qpeiie	qpeii
骒	cpiaee	cpia
骖	ppaoeu	ppa
骝	lpuaoa	lpuao
骟	fpoaeu	fpoa
骢	ppuiau	ppui
骣	zpaeua	zpae
骺	wwuuei	wwuu
髫	vqauia	vqau
髹	hquiei	hqui
鬏	jqueiu	jquei
鬲	reiaei	reiaei
鲐	vzaoia	vzao
鲒	jzeiei	jzei
鲕	pzeuia	pzeu
鲞	hzouee	hzou
鲣	jziiao	jzii
鲥	fziaee	fzia
鲦	vzuaoe	vzua
鲩	wzooae	wzoo
鲭	gzeeie	gzee
鲳	zziaee	zzia
鲴	rziaei	rziae
鲵	xzuiea	xzui
鲺	fzauia	fza
鲻	czaaai	cza
鲼	mzeiei	mzei
鲽	dzeiie	dzeiie
鳆	mzueia	mzue
鳋	bzaooi	bzao
鳐	kzuoou	kzuo
鳓	lzeiie	lzeii
鳘	tzueaa	tzu
鳜	rzeuou	rzeu
鹇	hnoiae	hno
鹋	tneiii	tnei
鹎	nnuiae	nnui
鹛	tnaieu	tna
鹣	jnouea	jnou
麈	ghoeei	ghoe
麴	qcuaou	qcu
黉	wseiie	wseii
黟	kluaou	klua
黥	qloeia	qlo
黪	plaoeu	plao
黹	glouia	glou
黻	mlouia	mloui
鼢	mruoau	mru
鼯	sreiae	srei
鼷	hruiiu	hrui
鼽	qxuaaa	qxua
齄	gxeiuo	gxei
龠	kjeiae	kjeiae
