ba	锁
bai	锶
bau	铯
baui	锼
bb	思
bba	饲
bbao	瘙
bbe	馓
bbu	馊
bc	素
bca	缫
bce	厮
bcee	纟
bci	缌
bco	缩
bcu	绥
bd	松
bda	桑
bdao	梭
bde	森
bdo	桫
bdu	叟
bdui	榫
be	丝
bee	隼
bei	蛳
beu	卅
beui	螋
bf	诉
bfa	诵
bfi	谡
bfia	兕
bfo	赛
bfoe	谇
bfu	讼
bg	损
bga	扫
bgao	搔
bgaoa	搡
bge	撒
bgei	撕
bgo	擞
bgoo	挲
bgu	搜
bh	四
bha	私
bhae	祀
bhai	祟
bhe	穗
bhei	穑
bheu	夙
bhi	孙
bhu	飧
bi	司
bia	嗓
biaa	咝
biao	唆
bie	嘶
biee	嗉
biei	嗽
bieio	嗦
bii	虽
biia	嗣
biio	唢
bio	嗍
bioe	嗾
bioo	噻
biu	嗖
bj	俗
bje	仨
bjei	僳
bjo	僧
bjou	伞
bk	斯
bka	狻
bkai	狲
bl	所
bla	埽
ble	寺
bleu	叁
blo	索
bloo	塞
blooo	厶
blou	丧
bloue	塑
blouei	啬
bm	色
bma	姒
bmao	糁
bmo	娑
bmu	嫂
bn	速
bna	鸶
bne	竦
bno	送
bnoo	邃
bnou	遂
bnu	飒
bo	洒
boa	涩
boae	汜
boe	淞
boei	涑
boeii	澌
boi	泗
boia	濉
boo	溯
bou	溲
bp	死
bpa	骚
bpe	宋
bpi	驷
bpu	宿
bq	岁
bqe	霰
bqei	崧
bqo	嵩
br	艘
bra	巳
bre	瑟
bri	肃
brio	琐
bs	肆
bsa	羧
bsi	腮
bsia	臊
bsu	脎
bt	碎
bta	磉
bu	算
bua	笋
buae	笥
buao	毵
bue	簌
bv	三
bva	苏
bvai	萨
bvaie	荪
bve	蒜
bvei	菘
bveia	蔌
bveiae	觫
bvo	蓑
bvou	薮
bvu	荽
bw	酸
bwe	髓
bwee	愫
bwei	悚
bwo	粟
bwu	酥
bwuo	怂
bwuoa	忪
bx	随
bxe	隋
bxi	耜
bxo	隧
bxu	耸
bxui	飕
by	散
bya	睃
bye	眭
byo	燧
byu	睢
byui	瞍
bz	稣
bza	颡
bzao	鳋
bze	凇
bzi	鳃
bzu	颂
ca	钻
caa	锱
cae	铐
caea	锴
caeai	錾
caei	钶
cai	铿
caia	铠
caiae	锟
caiaee	锃	锞
cao	钪
caoe	镞
caoi	锎
cb	款
cba	康
cbai	邝
cbe	库
cbi	馈
cbia	甾
cbo	廓
cbu	座
cc	组
cca	缁
cce	缂
ccei	氪
cceu	绔
cci	紫
cco	尊
ccoe	纩
ccoo	综
ccou	缯
ccu	纵
ccue	缵
ccuo	仄
cd	杂
cde	柯
cdea	楷
cdee	框
cdeee	楱
cdei	枯
cdeie	栽
cdeieu	栲
cdi	肯
cdia	棵
cdii	槛
cdo	棕
cdoe	梓
cdou	樽
ce	再
cea	蚤
cee	蝰
cei	罪
ceia	枣
ceo	罾
ceu	蝌
ceue	蛞
cf	资
cfe	责
cfea	谮
cfee	贼
cfeee	诓
cfei	诹
cfi	则
cfia	课
cfiae	诅
cfiaeu	贶
cfie	赀
cfiei	訾
cfo	赠
cfoe	赃
cfoeu	谘
cfu	赞
cfua	亢
cfuau	诳
cfuo	卒
cg	族
cga	择
cgaa	拶
cgao	揆
cge	扛
cgea	揩
cgee	揍
cgei	拷
cgeu	挎
cgeuo	抠
cgi	扣
cgia	捆
cgo	抗
cgoe	扩
cgoo	控
cgou	撙
cgu	括
cgue	攒
cgueo	攥
ch	子
cha	孔
che	困
chee	匡
chi	祖
chia	租
chiae	匮
chiaee	稞
chiai	凯
chiaii	匝
chii	赜
cho	科
chou	孳
chu	孜
chua	秭
chue	祚
ci	可
cia	咖
ciai	叩
ciaie	奘
cie	口
ciee	夸
cieee	哐
cieei	啧
ciei	奎
cieia	咂
cieie	哉
cieiea	嗑
cieii	戡
cieu	左
cieua	臧
cieuo	喹
cii	嘴
ciia	噪
ciiae	喟
ciie	啃
ciiee	咔
cio	咨
cioe	吭
cioo	喀
ciou	嗞
ciu	咱
ciue	咋
ciui	唣
ciuii	夼
ciuo	唑
ciuoe	哙
cj	作
cja	仔
cje	做
cjei	龛
cjeu	佐
cjeuo	侉
cji	侃
cjie	佧
cjo	伉
cjoo	倥
cju	俎
cjua	偬
cjuo	侩
ck	最
cka	辎
ckao	暌
cke	早
ckea	暂
ckeaa	皂
ckeau	昆
ckee	狂
ckei	载
ckeia	轲
ckeu	昃
cki	哭
cko	旷
cku	昨
ckua	昝
ckuo	狯
cl	在
cla	块
clae	垦
claeu	堀
cle	堪
clei	坷
cleu	垮
cli	克
clia	坤
cliai	垲
clo	增
cloa	壳
cloe	坑
cloeu	圹
cloo	魁
clou	凿
clu	考
clua	坎
cluo	坐
cm	刻
cma	籽
cme	刊
cmei	糟
cmeii	蒯
cmeu	刳
cmi	剀
cmo	姿
cmoe	糠
cmoeu	粢
cmoo	粽
cmu	姊
cmua	糌
cn	造
cne	遭
cnei	逵
cno	遵
cnu	迮
co	自
coa	泽
coaa	淄
coe	卡
coee	渍
coei	溘
coi	溃
coia	渴
coiae	澡
coo	滋
cooo	滓
cp	字
cpa	裉
cpe	宗
cpee	寇
cpei	宽
cpi	驵
cpia	骒
cpo	灾
cpoe	宰
cpoeu	裤
cpu	客
cpua	驺
cq	足
cqe	跨
cqei	岢
cqeie	跬
cqeu	髡
cqi	躁
cqia	崽
cqie	髭
cqiu	岿
cqo	踪
cqoo	鬃
cqooa	崆
cqou	嵫
cqu	尻
cque	躜
cr	兹
cre	琢
crei	珂
creu	夔
cri	琨
cro	甑
cru	瓒
crue	舴
cs	空
csa	窟
cse	窥
cseu	盔
cseuo	胯
csi	窠
csie	胩
cso	脏
csoa	喾
csoo	腙
csu	脍
csue	胙
ct	矿
cta	阚
cte	砸
ctei	磕
cti	阃
cto	阔
ctoe	闶
ctu	砍
cu	走
cua	龈
cuao	馗
cue	筐
cuea	簪
cuee	箦
cuei	筘
cui	纂
cuia	篑
cuie	龇
cuo	筷
cuoe	趑
cuoo	箜
cuu	笫
cuue	笮
cuuei	趱
cv	开
cva	亏
cvai	芤
cvao	葵
cve	苦
cvea	蒈
cvei	苛
cveie	莰
cveu	奏
cveua	葬
cvi	蒉
cvia	蕞
cvie	觜
cvo	藻
cvoo	蔻
cw	总
cwa	快
cwae	慨
cwaee	恳
cwe	恐
cwei	勘
cweii	骷
cwi	恺
cwia	髁
cwiae	愦
cwiaee	悝	醌
cwiaei	悃
cwo	醉
cwoe	慷
cwoeu	恣
cwoo	髋
cwou	憎
cwu	怎
cwua	恪
cwue	酷
cwuee	忾
cwuei	怍
cwui	愧
cx	靠
cxa	耔
cxe	鄹
cxei	陬
cxi	阻
cxia	聩
cxo	犒
cxu	邹
cxue	阼
cxui	隗
cxuo	郐
cy	看
cya	瞰
cyao	睽
cye	烤
cyee	眶
cyei	灶
cyeie	瞌
cyeu	眍
cyi	燥
cyie	眦
cyo	炕
cz	况
cza	鲻
cze	鲰
czee	帻
czi	颗
czia	鲲
czo	颏
czou	鳟
da	短
daa	铎
daao	镫
dae	豆
daea	钝
daee	刁
daei	钉
dai	铛
daia	锝
daiae	铞
dao	镀
daoe	镝
daoei	镦
daoo	锭
daooe	钭
dau	钓
daue	铤
dauei	铥
daui	锻
db	度
dba	癜
dbe	癫
dbei	瘩
dbeia	痘
dbeii	疔
dbi	店
dbia	疸
dbo	瘅
dbu	底
dc	躲
dca	绐
dce	牒
dcee	纛
dcei	牍
dco	缔
dcou	氮
dcu	缎
dcua	氡
dcue	缍
dcui	氘
dd	对
dda	邓
ddae	棣
ddao	叠
dde	杜
ddea	栋
ddei	椟
ddi	蛋
ddio	档
ddo	柁
ddu	柢
ddui	椴
de	东
dee	蝶
deei	蠹
deeii	甙
dei	丁
deo	蚪
deu	雕
df	调
dfe	读
dfei	订
dfeie	赌
dfeii	谍
dfi	党
dfio	谠
dfo	帝
dfoe	谛
dfou	赕
dfu	贷
dfua	诋
dfui	诞
dfuia	兜
dg	打
dga	掇
dge	搭
dgei	揲
dgeia	觌
dgi	担
dgie	掉
dgio	挡
dgo	抖
dgoe	掂
dgou	掸
dgu	抵
dgua	捣
dh	多
dha	殿
dhao	凳
dhe	朵
dhea	囤
dhee	祷
dhi	凼
dho	弹
dhoe	丹
dhu	段
dhuo	稻
di	大
dia	叨
diae	叼
diai	咄
diao	噔
die	夺
diea	吨
diei	戴
dieie	嘟
dieii	叮
dieiie	喋	耷
dieiiu	嗒
dieiu	呆
dieu	哒
dieuo	呔
dii	吊
diia	戥
dio	奠
dioe	嘀
dioo	啶
diou	啖
diu	咚
diua	哆
diuae	哚
diuo	嗲
dj	但
dja	貂
dje	代
djea	倒
djee	傣
djei	仃
dji	斗
djia	佃
djiae	侗
dju	低
djua	儋
djue	瓞
dk	的
dka	电
dke	旦
dkeu	鞑
dki	独
dkia	靼
dko	狄
dl	地
dla	堕
dlae	埭
dle	堵
dlea	垤
dlei	垫
dleia	黩
dleii	堞
dli	堤
dlia	垌
dlie	坫
dlo	断
dloe	墩
dloo	冬
dlu	堆
dlua	垛
dlue	丢
dlui	黛
dluu	耋
dm	到
dmi	妲
dmii	刂
dmo	妒
dmoe	嫡
dmou	娣
dmu	刀
dmua	剁
dmuo	籴
dn	道
dna	逮
dnao	迨
dne	达
dnea	鸫
dnee	毒
dnei	逗
dni	端
dnia	迪
dno	递
dnu	迭
dnuu	遁
do	点
doe	沌
doei	渎
doeii	滇
doi	洞
doia	沓
doo	淡
dooe	渡
dooeo	滴
dooo	淀
dou	涤
doua	澹
dp	定
dpa	殆
dpao	裰
dpe	宕
dpei	褡
dpi	裆
dpo	歹
dpou	殚
dpu	袋
dq	岛
dqa	蹬
dqao	嶝
dqe	巅
dqea	趸
dqeai	岽
dqei	蹀
dqi	峒
dqia	屌
dqo	蹲
dqoe	踱
dqoeu	踮
dqoo	靛
dqu	跌
dqua	跺
dqui	岱
dquo	蹈
dr	导
dra	弟
dre	玎
dri	单
dria	典
driae	兑
drie	玷
dro	舵
dru	玳
ds	当
dse	肚
dsea	胨
dsei	窦
dsi	胆
dsia	胴
dso	盗
dsoo	腚
dsu	羝
dt	得
dta	砀
dtao	磴
dte	德
dtea	砘
dtee	碡
dtei	待
dteii	碟
dti	甸
dtia	碘
dtiae	硐
dto	碇
dtoe	碲
dtoei	礅
dtu	碉
dtua	砥
dtui	碓
du	第
dua	笃
duae	氐
duao	簦
due	等
duei	簟
dui	笛
duia	笪
duo	箪
duou	簖
duu	答
duui	篼
dv	登
dve	芏
dvo	荡
dvoe	蒂
dvoo	菪
dvu	董
dvua	荻
dvuau	萏
dvui	蔸
dw	动
dwa	怠
dwao	怼
dwau	忉
dwe	懂
dwei	酊
dweu	惰
dwi	悼
dwia	恫
dwiae	怛
dwiai	髑
dwo	惮
dwoe	惦
dwoei	憝
dwu	爹
dwua	骶
dx	都
dxe	陡
dxei	犊
dxeii	耵
dxi	聃
dxie	阽
dxo	耽
dxou	郸
dxu	队
dxua	邸
dy	敌
dya	瞪
dyae	鼎
dye	灯
dyea	炖
dyeai	盹
dyee	焘
dyei	盯
dyeie	睹
dyi	督
dyo	敦
dyoa	眈
dyou	睇
dyu	盾
dyui	煅
dz	带
dze	顿
dzea	冻
dzei	顶
dzeii	颠
dzeiie	鲽
dzu	凋
dzua	鲷
dzui	翟
fa	书
faa	矧
fae	豉
fao	矢
faoe	铈
fau	铩
faua	铄
fauu	钐
fb	食
fba	扇
fbaa	饣
fbe	庶
fbi	蚀
fbia	疝
fbo	痧
fbu	饰
fbue	歃
fbui	瘦
fbuo	歙
fc	身
fca	绍
fcao	纾
fce	射
fcea	厍
fcee	寿
fceu	厦
fci	绳
fcia	绅
fcio	绱
fciu	纱
fco	缮
fcu	绶
fd	术
fda	双
fdao	树
fde	圣
fdei	椹
fdeu	枢
fdi	叔
fdio	梢
fdo	疏
fdoe	梳
fdoei	柿
fdou	槊
fdu	杀
fdua	栅
fduo	栓
fduu	杉
fe	事
fea	虱
fee	署
feei	螫
fei	束
feia	售
feio	蛸
feo	蛇
feoe	蟀
feou	蟮
feu	爽
feua	蜀
ff	说
ffe	试
ffei	诗
ffeia	赎
ffeie	誓
ffeii	贳
ffi	市
ffia	识
ffiae	衰
ffiaea	孰
ffiai	讪
ffio	赏
ffo	商
ffou	谥
ffu	设
ffua	赡
ffue	诜
ffui	谁
ffuo	赊
ffuoo	谂
fg	手
fga	抒
fgau	韶
fge	摄
fgee	拭
fgeee	扌
fgi	捎
fgie	摅
fgo	摔
fgoe	擅
fgou	搠
fgu	施
fguo	授
fguoe	拾
fguoee	拴
fguu	彡
fh	神
fhe	社
fhei	秫
fhi	视
fhia	蜃
fhio	稍
fho	示
fhoo	殳
fhooo	礻
fhou	税
fhu	麝
fhuo	黍
fi	式
fia	吮
fiae	唰
fie	奢
fiei	嗜
fieia	哂
fieu	戍
fii	哨
fiia	呻
fio	豕
fioe	唼
fiu	史
fiue	噬
fiuo	啥
fj	使
fja	似
fje	什
fjee	舍
fjeei	舒
fjeeiu	佘	畲
fjei	侍
fjeie	仕
fji	伸
fjiu	倏
fjo	受
fjoa	舜
fju	伤
fjui	傻
fk	是
fka	甚
fke	时
fkee	轼
fkei	匙
fkeia	晒
fkeie	暑
fki	申
fkia	曙
fkiu	狮
fko	狩
fku	输
fkui	晌
fkuo	猞
fl	十
fla	声
fle	士
fli	墅
flia	埘
flo	塾
floe	墒
flu	垧
flui	埏
fm	始
fma	刷
fme	耍
fmeo	孀
fmeu	娠
fmo	婶
fmoe	嬗
fmou	剡
fmu	剩
fmua	删
fmuao	妁
fmuau	姗
fmue	姝
fmuo	刹
fn	适
fne	述
fnei	逝
fni	竖
fo	上
foa	渗
foae	涮
foe	漱
foee	氵
foei	潸
foeie	澍
foeii	滠
foeiu	沭
foi	沙
foia	湿
foiai	汕
foie	涉
foiee	淑
foo	水
fooa	深
fooau	沈
fooo	渖
fou	潲
fp	实
fpe	室
fpei	守
fpi	审
fpia	驶
fpio	裳
fpo	裟
fpoa	骟
fpu	殊
fpue	殇
fpuu	衫
fq	山
fqe	霜
fqo	霎
fqou	屎
fqu	属
fqua	跚
fque	嵊
fquu	尸
fr	首
fra	鼠
fri	兽
fria	舢
frio	艄
fro	艏
fru	珊
fs	少
fsa	甩
fse	盛
fsi	尚
fsia	胂
fsii	肾
fso	善
fsoe	膻
fsou	朔
fsoue	膳
fsu	胜
fsuo	腧
ft	石
fte	硕
ftee	闩
fti	砂
ftia	砷
fto	勺
ftu	闪
fu	失
fua	氏
fue	舌
fuei	筮
fui	筛
fuio	筲
fuo	释
fuoe	弑
fuu	笙
fuua	舐
fuuo	毹
fv	世
fva	蔬
fvau	苕
fve	蓍
fvi	薯
fvia	莳
fvie	苫
fviee	菽
fvo	莎
fvoe	莘
fvou	蒴
fvu	升
fvua	芍
fvuaa	芟
fvue	觞
fw	势
fwa	恕
fwau	劭
fwe	慎
fwei	慑
fweia	酾
fweie	恃
fx	生
fxa	邵
fxe	陕
fxei	甥
fxo	鄯
fxu	牲
fy	数
fya	收
fye	烧
fyeu	炻
fyi	省
fyo	熟
fyoa	煽
fyoe	熵
fyu	睡
fyua	煞
fyuai	烁
fyue	眚
fyuo	瞬
fz	师
fza	鲺
fzi	帅
fzia	鲥
fzo	鲨
fzou	鳝
fzu	顺
fzue	赦
ga	知
gae	镇
gaee	铸
gaei	针
gaeie	锗
gaeiei	钲
gai	钟
gaia	镯
gaiau	铡
gaii	钊
gau	锥
gaua	铮
gaue	铢
gauei	锺
gaui	雉
gb	庄
gba	馔
gbe	症
gbei	痔
gbeie	痣
gbeu	瘃
gbo	瘴
gboe	疰
gbu	疹
gbua	瘵
gbue	痄
gbuo	畛
gc	终
gca	缀
gce	纣
gcei	缜
gceie	絷
gci	织
gco	绽
gcu	纸
gcua	绉
gcui	缒
gd	正
gda	札
gdao	杼
gde	整
gdea	桎
gdee	止
gdeea	栈
gdeee	榛
gdei	植
gdeia	枝
gdeii	栉
gdeiu	楂
gdeu	杖
gdeui	柘
gdi	桢
gdia	枳
gdie	棹
gdo	柱
gdoa	枕
gdoae	槠
gdoe	桩
gdoeo	樟
gdoo	寨
gdooa	榨
gdu	株
gdua	橥
gdue	柞
gduu	栀
ge	置
gea	臻
gee	蛰
geea	蛭
geee	隹
geei	蜇
gei	罩
geo	蛀
geoe	蟑
geu	丈
geua	螽
geue	蛛
geuee	蜘
geuei	蚱
gf	证
gfa	诏
gfe	诸
gfee	赘
gfei	贽
gfeu	斋
gfeua	诼
gfeue	赈
gfi	衷
gfo	赚
gfoe	谆
gfoeo	谪
gfoo	贮
gfu	质
gfua	诤
gfuaa	诌
gfuae	谵
gfue	账
gfuee	诛
gfuei	诈
gfuo	诊
gg	指
gga	招
ggaa	扎
ggae	撰
ggaeu	搌
ggai	拙
ggaia	拯
ggao	摺
ggaoe	擢
gge	找
ggei	章
ggeie	挚
ggeiu	揸
ggeu	振
ggi	掌
ggia	捉
ggiae	拽
ggo	撞
ggoe	摘
ggoee	拄
ggoeo	彰
ggoeu	摭
ggou	掷
ggu	执
ggua	挣
ggue	旃
gguu	抓
gguue	折
gh	种
ghe	周
ghei	稹
ghi	祝
ghia	咒
ghie	祯
ghiei	祉
gho	粥
ghoe	麈
ghou	禚
ghu	张
ghua	祗
ghue	秩
ghui	稚
gi	中
gia	嘱
gie	哲
giea	啭
giei	吱
gieie	哳
gieiu	喳
gieu	啄
gii	战
gio	咤
giu	只
giua	啁
giue	吒
gj	住
gje	值
gjea	侄
gjee	债
gjei	斟
gjeu	仗
gji	侦
gjia	仲
gjie	倬
gjo	爪
gjoo	伫
gju	众
gjua	仉
gjue	侏
gjuu	豸
gk	转
gka	昭
gkae	辗
gke	猪
gkea	轾
gkei	辄
gki	轴
gkia	轵
gko	辙
gkoe	獐
gku	智
gkua	旨
gkuaa	狰
gkuo	轸
gkuu	斩
gl	者
gla	支
glai	坠
gle	至
glei	埴
gli	真
glia	直
glie	址
glo	志
gloo	夂
glou	黹
glu	圳
gm	制
gma	争
gme	詹
gmi	召
gmia	妯
gmie	粘
gmo	肇
gmoe	嫜
gn	这
gne	逐
gnei	鸷
gni	站
gno	遮
gnoa	鸩
gnoe	鹧
gnu	追
go	之
goa	治
goae	涨
goao	濯
goau	沼
goe	浙
goei	滞
goeie	渚
goeii	汁
goeiie	湛
goeiu	渣
goeu	涿
goi	占
goia	桌
goiae	卓
goiaei	浊	浞
goiau	贞
goie	沾
goiei	浈
goo	注
gooe	漳
gooo	丶
goou	洲
gou	州
goua	潴
goue	洙
gp	装
gpa	褶
gpai	骘
gpe	殖
gpei	骤
gpeu	冢
gpi	宙
gpo	驻
gpu	宅
gpui	骓
gq	展
gqe	震
gqea	崭
gqei	峙
gqeu	跖
gqi	趾
gqia	躅
gqo	昼
gqoe	嶂
gqoi	咫
gqou	踯
gqu	踵
gqua	峥
gquu	踬
gr	主
gre	甄
gri	舯
gria	舳
gro	舟
groa	帚
groe	璋
gru	珠
grue	彘
gruo	珍
gs	着
gsa	妆
gse	状
gsea	窒
gseai	肫
gseaia	窀
gsee	盏
gsei	壮
gseia	肢
gseio	肘
gsi	肿
gsia	盅
gsiae	胄
gso	朕
gsoo	膣
gsu	胀
gsua	脂
gsuae	胝
gsue	窄
gsuo	胗
gt	征
gte	砖
gti	闸
gtia	徵
gtie	砧
gtiei	砦
gtu	斫
gtua	磔
gtue	砟
gu	长
gua	篆
gue	朱
guee	竺
guei	筑
gueie	乍
gueieu	箸	籀
gueiu	竹
gueu	箴
gui	毡
guo	兆
guu	赵
guua	筝
guue	卮
guuu	笊
gv	重
gva	专
gvaa	荮
gvai	蒸
gvaii	茁
gve	著
gvee	蓁
gvei	蘸
gvi	芷
gvo	芝
gvoe	蔗
gvoo	苎
gvou	觯
gvu	皱
gvue	茱
gw	助
gwe	怔
gwei	忮
gweio	酎
gwi	忠
gwia	惴
gwo	戆
gwu	酌
gwua	酯
gx	职
gxe	阵
gxea	郅
gxei	齄
gxi	陟
gxo	郑
gxoe	障
gxoeo	鄣
gxu	邾
gy	政
gya	瞩
gye	致
gyei	煮
gyi	照
gyia	烛
gyo	炷
gyu	炸
gyua	睁
gyuae	瞻
gyuao	灼
gyuaoo	炙
gyuo	眨
gz	准
gze	赭
gzee	鲭
gzei	翥
gzi	帜
gzia	颛
gzie	帧
gzo	幛
gzu	帐
gzue	帙
ha	销
haa	乡
hae	镡
hai	锡
hao	镶
haoe	锌
haoea	铉
haoeau	镟
hau	锈
haue	铣
hauo	鑫
hauu	锨
hb	序
hba	飨
hbe	席
hbi	歇
hbo	痫
hboe	痃
hbou	馐
hboue	庠
hbu	饷
hbua	馅
hbuai	癣
hbuaia	廨
hbue	饩
hbui	庥
hbuo	欷
hc	系
hca	絮
hce	线
hcei	续
hceie	绪
hceiei	缬
hceii	绁
hceiu	厢
hceiuo	缃
hci	细
hcia	氙
hcio	绡
hcu	纤
hcua	绚
hcue	绣
hd	相
hda	栩
hdae	榍
hdaeu	樨
hde	戏
hdea	朽
hdee	械
hdeee	楔
hdi	杏
hdia	胥
hdiae	枵
hdiaee	柙
hdo	校
hdoe	燮
hdoo	楦
hdu	析
hdua	橡
hduao	枭
hdui	榭
hduia	檄
hduo	叙
he	西
hee	雄
heei	虾
heeiu	蜥
hei	辛
heia	蝎
heiau	蚬
heu	蟹
heua	蟓
heui	螅
heuo	蟋
hf	许
hfa	讯
hfaa	玄
hfao	诩
hfe	谐
hfei	亵
hfi	享
hfia	襄
hfie	谑
hfii	贤
hfo	袭
hfou	详
hfu	谢
hfua	询
hfui	训
hfuo	谖
hg	形
hge	须
hgei	撷
hgeiu	觋
hgeo	挟
hgo	揎
hgu	旋
hgua	歆
hgui	携
hguia	擤
hguu	掀
hh	血
hha	秀
hhe	禧
hhee	祆
hheee	禊
hhi	香
hhia	匣
hho	祥
hhoe	弦
hhoo	夕
hhou	衅
hhu	凶
hhuo	稀
hi	向
hia	啸
hie	项
hiea	哓
hiei	吓
hieie	嘻
hieieu	哮
hieu	咸
hieue	戌
hii	嘘
hiia	嚣
hiie	嚱
hio	喧
hiu	响
hiua	吸
hiuaa	兄
hiui	嗅
hiuie	咻
hiuo	唏
hj	信
hja	奚
hje	休
hjea	偕
hjei	僖
hjeo	侠
hji	修
hjia	仙
hjiai	儇
hju	像
hjui	貅
hjuo	斜
hk	显
hka	暇
hke	献
hkea	晓
hkee	轩
hkei	鞋
hkeii	昔
hkeiu	晰
hkeiuo	皙
hkeo	狭
hki	猩
hkia	狎
hko	辖
hkoo	暄
hkou	曦
hku	星
hkua	旭
hkuao	舄
hkuau	獬
hkue	獯
hkuei	曛
hkui	靴
hkuo	猃
hkuu	昕
hl	新
hla	协
hlai	馨
hle	型
hlei	黠
hleu	夏
hli	喜
hlia	县
hliae	埙
hlie	墟
hlio	魈
hlo	幸
hlu	欣
hlua	孝
hm	象
hma	婿
hmai	糈
hme	刑
hmei	嬉
hmeia	粞
hmi	削
hmia	籼
hmo	嫌
hmoi	娴
hmu	姓
hmui	媳
hn	选
hna	迅
hnaa	巡
hnae	遐
hnai	逊
hni	逍
hnia	暹
hno	鹇
hnu	邂
hnui	鸺
ho	下
hoa	汛
hoae	浔
hoe	泄
hoei	湘
hoeii	潇
hoeiie	渫
hoeiio	荥
hoeiu	淅
hoi	消
hoie	瀣
hoo	息
hooa	泻
hooe	漩
hooea	泫
hooo	渲
hou	洗
houa	洵
houao	汐
houi	涎
houia	溴
houiai	洫
houo	溪
houoa	汹
houoe	淆
houoee	溆
houoeu	浠
hp	写
hpe	宣
hpea	骁
hpi	袖
hpio	宵
hpo	骧
hpu	宪
hpua	殉
hpui	驯
hq	需
hqa	雪
hqae	霞
hqe	峡
hqei	踅
hqi	屑
hqia	岫
hqiau	岘
hqio	霄
hqioe	犀
hqo	躞
hqu	峋
hque	跹
hquei	跣
hqui	髹
hquo	崤
hquu	屣
hr	现
hra	瑕
hrae	巽
hre	寻
hrea	兮
hrei	巷
hreia	舾
hreu	顼
hro	璇
hroe	舷
hru	玺
hrui	鼷
hs	学
hsa	胁
hsai	羞
hsao	翔
hse	兴
hsei	膝
hsi	虚
hsia	肖
hsiae	腥
hso	小
hsoa	泶
hsoe	羡
hsoeo	窨
hsoo	穴
hsu	胸
hsua	穸
hsue	羲
hsui	腺
ht	行
hte	闲
htee	硎
htei	硒
hteo	硖
hti	旬
htie	徙
htio	硝
hto	碹
htu	徐
htua	徇
htuao	矽
htue	衔
htui	阋
htuo	匈
htuu	循
hu	笑
hua	箫
hue	箱
hui	囟
huu	筱
huue	筅
hv	些
hva	萧
hvaa	芗
hve	菥
hvei	葙
hveia	蕈
hveu	薤
hvi	苋
hvia	葸
hvo	蓄
hvoa	芯
hvoe	薪
hvoo	蓿
hvooa	萱
hvu	薛
hvua	荀
hvuai	藓
hvue	薰
hvuo	莶
hvuu	荇
hvuui	蓰
hw	心
hwa	勰
hwai	醑
hwe	想
hwei	惜
hweie	悻
hwi	醒
hwia	悬
hwiae	勋
hwiaee	惺	勖
hwii	忄
hwo	醯
hwu	性
hwua	懈
hwuai	恂
hwue	酰
hwuei	醺
hwui	恤
hwuo	悉
hwuoa	酗
hwuu	忻
hx	先
hxa	限
hxao	陉
hxe	邪
hxee	邢
hxei	牺
hxi	隙
hxia	隰
hxu	险
hxua	陷
hxue	卸
hxuo	郗
hy	效
hya	熊
hye	熙
hyee	盱
hyei	熹
hyeu	燹
hyi	煦
hyie	罅
hyo	瞎
hyoe	眩
hyoea	炫
hyoo	煊
hyu	熄
hyue	熏
hyuo	烯
hz	希
hza	习
hzae	鲟
hze	颉
hzeo	鳕
hzo	鲜
hzou	鲞
hzu	翕
hzue	冼
ja	金
jaa	键
jaaa	钅
jaae	锯
jaaeu	锔
jaao	畿
jae	矩
jaea	钜
jaei	豇
jaeo	铗
jaeu	镢
jai	鉴
jaia	钾
jaiau	卺
jaie	乩
jaii	亟
jao	镜
jaoa	矜
jaoe	铰
jaoi	锏
jaoo	镓
jaou	锩
jau	锦
jaua	钧
jaue	矫
jaui	镌
jb	界
jba	痉
jbae	瘕
jbai	疖
jbau	痂
jbe	畸
jbee	饯
jbei	馑
jbeii	廑
jbi	肩
jbia	疽
jbiai	扃
jbo	饺
jboe	瘠
jbu	疾
jbua	饥
jbuao	疚
jbuo	疥
jc	经
jca	纪
jcae	厩
jcai	纠
jce	结
jcee	绩
jcei	缰
jceii	缙
jceu	缄
jci	紧
jcia	绢
jciae	缉
jco	继
jcoe	绞
jcou	厥
jcoue	缣
jcu	级
jcua	绝
jcuao	绛
jcui	缴
jd	机
jda	架
jdae	艰
jdaee	楗
jdaeu	椐
jdao	橘
jdau	枷
jde	桔
jdei	槿
jdeu	柩
jdeuo	橛
jdi	椒
jdia	楫
jdiae	矍
jdiau	枧
jdo	杰
jdoe	桨
jdoo	榉
jdou	桊
jdu	极
jdua	鸡
jduao	桀
jduau	桷
jdue	榘
jdui	桕
jduo	检
je	集
jea	隽
jee	截
jeea	戋
jeei	羁
jeeo	蛱
jei	棘
jeia	柬
jeiae	雎
jeie	韭
jeo	焦
jeoe	蛟
jeou	夹
jeu	蚧
jeua	虮
jeui	丌
jf	就
jfa	记
jfae	诀
jfaeu	赆
jfao	谲
jfe	计
jfea	讵
jfee	讲
jfeea	贱
jfeei	讦
jfeeu	诫
jfei	警
jfeia	谏
jfeie	诘
jfeii	谨
jfeiu	赍
jfi	京
jfie	齑
jfo	謇
jfou	谫
jfu	交
jfua	讥
jg	见
jga	据
jgae	掘
jgaee	捃
jgaeu	抉
jge	技
jgea	拒
jgeaa	拣
jgeae	捷
jgei	觐
jgeie	拮
jgeu	撅
jgeuo	掎
jgi	揭
jgia	捐
jgiae	攫
jgiai	觊
jgo	接
jgoe	挤
jgoo	搅
jgou	搛
jgu	竟
jgua	拘
jguao	掬
jgue	揪
jgueu	旌
jgueuo	挢
jguo	捡
jh	几
jha	巨
jhaa	冂
jhai	季
jhaie	囝
jhaiee	孑
jhaio	孓
jhao	弪
jhe	禁
jhei	疆
jheie	秸
jheu	稽
jheua	嵇
jhi	积
jhia	稷
jho	稼
jhu	祭
jhua	麂
jhue	麇
jhuu	匠
ji	叫
jia	君
jiae	唧
jie	戒
jiea	喈
jiei	戟
jieie	咭
jieii	戬
jieiu	噤
jieu	戛
jieuo	噘
jii	咀
jiia	戢
jiie	噱
jio	奖
jioe	哜
jiou	嗟
jiu	嚼
jiua	叽
jiuao	咎
jiue	啾
jiui	噍
jj	件
jja	仅
jjae	假
jjaee	健
jjaeu	倔
jjaeue	倨
jjao	俊
jje	借
jjea	侥
jjeau	僭
jjei	佳
jjeia	僵
jjeiao	伎
jjeie	佶
jjeii	儆
jji	俱
jjia	爵
jjiae	偈
jjo	今
jjoe	佼
jjoei	僦
jjou	倦
jju	价
jjui	介
jjuio	僬
jjuo	俭
jk	基
jke	晋
jkee	臼
jkei	鞯
jkeu	獗
jki	旧
jkia	辑
jkiae	晶
jkiaee	狙
jkiaei	舅	狷
jkii	甲
jko	较
jkoe	景
jkoeo	獍
jkoeu	狡
jkoeuo	皎
jkou	炅
jku	轿
jkua	鞠
jkuao	鞫
jkuu	靳
jl	即
jle	既
jlea	暨
jlei	墼
jli	坚
jlia	吉
jliae	嘉
jliaeu	兢
jlii	斤
jlo	境
jlu	均
jlua	圾
jm	精
jma	剧
jmaa	剿
jmae	糨
jmao	刭
jme	奸
jmea	婕
jmee	婧
jmei	荆
jmeia	妓
jmeiae	粳
jmeii	姬
jmeu	剞
jmeuo	劂
jmi	姐
jmia	娟
jmo	剂
jmoe	嫉
jmoeu	姣
jmoo	嫁
jmou	剪
jmu	剑
jmue	娇
jmuo	妗
jn	进
jna	建
jnao	竣
jnaoe	迳
jnau	迦
jne	靖
jni	竞
jnia	竭
jniae	鹃
jniai	迥
jnie	遽
jno	迹
jnoe	鹫
jnou	鹣
jnu	近
jnua	鸠
jnui	鹪
jo	济
joa	津
joae	浸
joao	浚
joaoe	泾
joe	江
joea	渐
joeau	浇
joei	酒
joeie	洁
joeo	浃
joi	沮
joia	溅
joiae	涓
joo	浆
jooi	涧
joou	湔
jou	激
joua	汲
jouao	洚
joue	湫
joui	洎
jp	家
jpa	驾
jpae	裾
jpai	殛
jpao	骏
jpau	袈
jpe	军
jpei	襟
jpeu	寄
jpi	寂
jpie	骥
jpo	裥
jpu	歼
jpua	驹
jpue	骄
jpuo	袷
jpuoo	衿
jq	局
jqa	峻
jqae	崛
jqaea	跽
jqaee	踺
jqaeu	踞
jqau	跏
jqe	居
jqea	距
jqee	践
jqeeu	趼
jqei	髻
jqeu	蹶
jqi	届
jqia	岬
jqiau	靓
jqo	尽
jqoe	跤
jqoeu	跻
jqoeuo	霁	嵴
jqoo	蹇
jqu	静
jqua	岌
jque	峤
jquei	鬏
jqui	踽
jquu	屐
jquui	屦
jr	己
jra	珈
jrae	琚
jraeu	玦
jre	卷
jrea	兼
jree	珏
jreee	彐
jrei	瑾
jreu	蠲
jri	具
jria	舰
jrie	冀
jro	忌
jru	玑
jrua	玖
js	将
jsa	姜
jsae	窘
jsaee	腱
jsao	胫
jse	举
jsee	肼
jseei	腈
jsei	脚
jseu	尖
jsi	监
jsia	胛
jsiae	羯
jso	觉
jsoe	胶
jsoeu	脊
jsou	窭
jsu	究
jsua	肌
jsue	窖
jsui	皆
jt	间
jta	径
jte	街
jtei	礓
jteu	碱
jti	句
jtia	碣
jtu	礁
jtua	矶
jtuai	阄
jtui	徼
jtuo	硷
ju	及
jua	九
juae	毽
juai	赳
juao	久
juau	笳
jue	籍
juee	笺
jueeu	笄
juei	箕
jui	趄
juia	笕
juiae	龃
juo	简
juou	箭
juu	筋
juua	笈
jv	解
jva	节
jvae	荩
jvaei	葭
jvaeu	觖
jvao	茎
jvau	茄
jve	荐
jvea	苣
jvee	藉
jveei	菁
jvei	芰
jveia	堇
jveo	荚
jveu	蕨
jvi	击
jvia	菌
jviae	茧
jviaee	苴	蕺
jviaei	莒
jvii	角
jvo	蒋
jvoa	皲
jvoe	蒺
jvoeu	荠
jvoeuo	茭
jvoo	菅
jvooe	菹
jvooee	茳
jvou	蒹
jvu	井
jvua	菊
jvuaa	艽
jvuai	蓟
jvuao	芨
jvui	蕉
jvuo	芥
jw	加
jwa	劲
jwe	劫
jwee	恝
jwei	酵
jwi	惧
jwia	贾
jwiae	憬
jwie	醵
jwo	惊
jwoe	酱
jwu	急
jwue	悸
jwui	醮
jwuo	骱
jx	际
jxa	聚
jxae	郡
jxaea	犟
jxaee	犍
jxe	阱
jxee	耩
jxei	鄄
jxeo	郏
jxeu	犄
jxi	飓
jxia	犋
jxii	卩
jxo	郊
jxu	降
jxui	牮
jxuo	阶
jy	教
jya	烬
jye	救
jyea	睫
jyeae	炬
jyee	睛
jyei	敬
jyi	炯
jyo	煎
jyou	眷
jyu	睑
jyua	灸
jyui	敫
jyuo	爝
jz	决
jza	颈
jzae	鲫
jze	减
jzei	鲒
jzeo	颊
jzi	巾
jzii	鲣
jzo	鲸
jzoe	鲛
jzoeu	鲚
jzou	翦
jzu	净
ka	也
kaa	银
kaaa	乙
kaaaa	钇
kae	钰
kaea	钺
kaeai	铘
kaee	肀
kaei	蓥
kaeu	铕
kai	铀
kaia	铟
kao	予
kaoa	豫
kaoe	铱
kaoeo	镱
kaoeu	镛
kaou	镒
kau	钥
kauo	铫
kb	应
kba	庸
kbai	瘾
kbao	饴
kbau	疡
kbe	疣
kbea	欤
kbeae	痍
kbei	痖
kbeo	瘗
kbeu	欹
kbi	邕
kbia	瘿
kbo	痒
kboe	瘀
kboea	饔
kboeo	癔
kbu	欲
kbua	饮
kbuaa	疫
kbuae	痈
kbue	饫
kbui	鹰
kbuie	庾
kbuiea	瘐
kbuiu	膺
kbuo	馀
kc	原
kca	缘
kcao	绎
kce	严
kcee	纭
kceei	纡
kcei	压
kceii	萦
kceiio	氩
kceu	厌
kceuo	魇
kceuoo	靥	餍	厣
kci	缨
kcia	氲
kciae	氤
kco	氧
kcoa	牖
kcou	缢
kcu	约
kcui	雁
kcuiu	赝
kcuo	繇
kd	样
kda	杨
kdaa	橼
kdau	楹
kde	友
kdei	椰
kdeie	樾
kdeii	桠
kdeu	椅
kdi	樱
kdia	杳
kdiae	柚
kdo	又
kdu	疑
kdua	檐
kduo	榆
ke	一
kea	与
keaa	蚴
keae	夷
keaea	蚓
keai	牙
keao	蛹
keaoo	弋
kee	雅
keea	蚜
keei	萤
keeia	蜮
keeu	鼋
keeuo	罨
keeuu	螈
kei	蝇
keia	蜴
keiae	蚰
keo	蚁
keoe	蝣
keou	蛘
keu	蜒
keuo	蝓
kf	用
kfa	育
kfaa	雍
kfaaa	讠
kfao	译
kfaoi	贻
kfaoia	甬	诒
kfe	言
kfea	讶
kfeau	尧
kfei	语
kfeii	谳
kfi	谒
kfo	议
kfoe	赢
kfoeo	谚
kfoo	誉
kfooa	谊
kfou	彦
kfu	夜
kfua	诣
kfue	诱
kfui	亦
kfuie	谀
kfuo	谕
kfuoa	兖
kfuoo	谣
kg	意
kga	扬
kgaa	掾
kge	音
kgei	揶
kgeia	揠
kgeu	掩
kgi	影
kgia	押
kgiae	揖
kgiaea	挹
kgiau	撄
kgo	掖
kgu	摇
kgua	拥
kguaa	抑
kguao	韵
kgue	旖
kguo	援
kguoe	觎
kguoei	揄
kguoo	於
kh	因
kha	孕
khe	园
khei	圄
kheie	圉
kheu	囿
khi	引
khia	圆
khiae	秧
kho	毅
khoo	夤
khou	鬻
khu	医
khua	移
khuu	殷
ki	员
kia	幽
kiaa	哟
kiaao	吆
kiaaoa	呦
kiae	吲
kiai	邑
kie	右
kiea	呀
kieae	咦
kiee	吁
kiei	叶
kieie	噎
kieii	哑
kieiia	呓
kii	央
kiia	咽
kiiae	奄
kiiaee	喁
kiiai	哕
kiiau	嘤
kio	咬
kioa	咏
kioe	奕
kioea	唷
kioee	唁
kioeo	噫
kioeou	喑
kiou	吖
kiu	吟
kiui	咿
kiuo	喻
kj	以
kja	伊
kjaa	亿
kjao	俑
kje	余
kjea	伢
kjee	爰
kjei	俞
kjeia	偃
kjeiae	龠
kjeii	俨
kjeu	优
kjeui	佑
kjeuia	侑
kjeuo	倚
kjeuoa	伛
kji	攸
kjia	俣
kjo	依
kjou	仪
kjoue	佯
kju	仰
kjua	佣
kjue	佚
kjui	舀
kjuo	佾
kk	由
kka	轧
kkao	曜
kkaou	狁
kkau	曳
kkaui	轺
kke	犹
kkei	猿
kkeie	辕
kkeu	猗
kkeui	舁
kki	映
kkia	曰
kkiae	鞅
kkiai	禺
kko	狱
kkoa	晕
kkoe	昱
kkoee	狺
kkoo	晏
kkou	猷
kku	易
kkua	昀
kkue	轶
kkui	晔
kkuo	臾
kkuoe	狳
kl	业
kla	黝
klaa	幺
klae	垠
klaea	圯
klai	邺
kle	亚
klei	域
kleia	垣
kleiae	堰
kleiai	堙
kleii	垭
kleiio	茔
kleu	塬
kli	袁
klia	埸
klo	懿
kloa	壹
kloe	壅
kloeu	墉
kloo	垸
klu	允
klua	黟
klue	矣
km	妖
kma	妤
kme	姨
kmee	妍
kmei	娅
kmeie	嫣
kmeu	妪
kmi	姻
kmia	婴
kmiae	娱
kmii	聿
kmo	嬴
kmu	姚
kmua	肄
kmuo	媛
kmuoi	刈
kn	运
kna	翊
knao	鹬
kne	远
knea	鸦
kneai	迓
kneao	鸢
knee	迂
knei	莺
kni	遗
knia	遇
kniae	鸭
kniaeu	鸯
kniau	鹦
kno	廴
knu	迎
knua	逸
knuao	鸳
knue	迤
knui	延
knuia	邀
knuo	遥
knuoe	逾
knuoo	鹞
knuou	鹆
ko	义
koa	永
koao	涌
koe	源
koee	沅
koeee	滟
koei	湮
koeii	滢
koeiio	潆
koeu	淹
koeue	涯
koi	油
koia	泱
koiaa	卣
koiae	洇
koo	游
kooa	泳
kooe	液
kooea	淤
kooeai	瀛
kooo	演
koou	洋
kooue	溢
koouee	漾
kou	沿
koua	渔
kouau	漪
koui	丫
kouo	渊
kouoe	渝
kouoei	瀹
kouoo	淫
kouou	浴
kouu	沂
kp	验
kpa	驭
kpao	驿
kpe	宇
kpei	寅
kpeie	殪
kpeu	宥
kpi	宜
kpia	宴
kpiae	寓
kpiaei	殒
kpiaeu	殃
kpiau	裔
kpo	衣
kpoo	衤
kpu	裕
kpua	冤
kq	雨
kqa	踊
kqao	峄
kqe	岩
kqea	屿
kqeai	岈
kqee	雩
kqei	崾
kqeu	崖
kqeuo	崦
kqi	韫
kqo	霪
kqu	跃
kqua	嶷
kque	屹
kqui	岳
kquo	峪
kquoe	嵛
kr	已
kre	益
krea	琊
kree	养
krei	莹
kreii	瑛
kreu	异
kri	鼹
kria	鼬
kriau	璎
kro	玉
krou	琰
krouo	舣
kru	舆
kruo	瑜
kruoe	珧
kruoo	瑶
kruoou	瑗
kruu	尹
ks	有
ksa	野
ksaa	窈
ksau	盈
kse	月
ksea	胰
ksee	盂
ksei	腰
kseie	盐
kseu	耀
kseuo	腌
ksi	羊
ksia	虞
ksiae	胭
ksii	刖
kso	腋
ksoa	恙
ksoe	臆
ksoea	臃
ksou	媵
ksu	窑
ksui	腴
ksuo	肴
ksuoe	窬
ksuu	窳
kt	研
kte	硬
ktea	砑
ktee	闫
ktei	衙
kteia	阈
kteu	阉
kti	砚
kto	阅
ktoe	匀
ktoo	衍
ktou	徉
ktu	役
ktua	阎
ktue	御
ktuo	徭
ku	越
kua	胤
kue	毓
kuee	竽
kuei	筠
kueia	龉
kueu	夭
kui	禹
kuia	粤
kuo	釉
kuoo	箢
kuou	爻
kuu	筵
kv	于
kva	药
kvaa	艺
kvaaa	尢
kvaae	蕴
kvaaeo	彝
kvai	荫
kvao	云
kvaoa	蓣
kvaou	苡
kve	艳
kvea	芽
kvee	芸
kveei	芋
kveeu	芫
kvi	英
kvia	茵
kvo	营
kvoe	弈
kvoea	菸
kvoeo	薏
kvoo	尤
kvu	元
kvua	苑
kvuae	茚
kvuau	莸
kvue	莠
kvui	萸
kvuii	莜
kw	要
kwa	爷
kwaa	忆
kwaao	幼
kwai	酏
kwao	勇
kwaoe	怿
kwaoi	怡
kwaoia	恿
kwe	愿
kwee	酝
kweee	酉
kwei	酽
kweu	忧
kweue	恹
kwi	愚
kwia	怏
kwiae	愠
kwiaea	悒
kwo	悦
kwoa	恽
kwoe	慵
kwu	愈
kwua	怨
kwui	悠
kwuo	愉
kx	院
kxa	耶
kxe	郁
kxee	耘
kxei	鄢
kxeia	郾
kxeii	鄞
kxi	阳
kxia	邮
kxiae	陨
kxiaee	隅	郢
kxiaei	郧
kxii	劓
kxo	郓
kxu	印
kxua	阴
kxuaa	隐
ky	眼
kya	熠
kyae	熨
kyao	眙
kyau	炀
kye	燕
kyei	焉
kyeii	荧
kyeu	睚
kyi	烟
kyia	煜
kyiau	罂
kyo	炎
kyou	烊
kyouu	焱
kyu	焰
kyua	眢
kyui	烨
kyuia	燠
kz	预
kza	冶
kze	鱼
kzee	羽
kzei	颐
kzeu	鱿
kzeue	翳
kzeui	羿
kzi	翼
kzo	页
kzoe	颜
kzoeo	翌
kzoeu	鳙
kzu	颖
kzua	颍
kzuo	鳐
la	了
laa	钌
lae	链
laei	铑
laeii	铹
laeo	镭
laeou	铼
laeu	镣
lai	锣
laia	铝
laiae	锂
laiaei	镙
lao	镰
laoa	锒
laoe	銮
laoea	锍
laoi	镧
laoo	鎏
laou	镂
lau	铃
laua	镏
lauai	镥
lauo	锊
lb	留
lba	疗
lbaa	累
lbai	癃
lbao	廖
lbe	癞
lbea	疠
lbei	痨
lbeia	瘌
lbeu	戾
lbeua	疬
lbi	瘰
lbo	廉
lboa	廊
lboae	庐
lboe	廪
lbou	瘘
lbu	略
lbua	瘤
lbuao	馏
lbue	痢
lc	历
lca	绿
lcae	氯
lce	练
lcea	厉
lcei	绫
lceu	缭
lci	厘
lcia	缧
lcii	缆
lco	缕
lcoe	缡
lcu	络
lcua	绺
lcuo	纶
ld	林
lda	李
ldae	棂
lde	棱
ldei	楝
ldeie	栳
ldeo	檑
ldeu	枥
ldeua	栊
ldi	楞
ldia	椤
ldie	栌
ldii	榄
ldo	楼
ldoa	榔
ldoe	椋
ldoei	栾
ldoeia	檩
ldoi	榈
ldoo	梁
ldou	栏
ldu	柳
ldua	榴
lduai	橹
lduaiu	栎
ldue	梨
lduo	柃
le	来
lea	蠡
lee	辣
leei	蜡
leeii	罱
leeu	蛎
lei	两
leia	丽
leiae	吏
leiaei	螺
leo	螂
leoe	詈
leoea	蠃
leoeu	蠊
leoo	罹
leou	蝼
leu	罗
leua	雒
leue	蜊
leuo	蛉
lf	论
lfa	率
lfe	赖
lfee	诔
lfei	垄
lfeii	聋
lfeo	赉
lfeu	砻
lfi	刘
lfia	亮
lfiae	吝
lfii	脔
lfo	龙
lfoe	谅
lfoi	斓
lfoia	谰
lfu	离
lfua	赂
lfui	赁
lfuo	六
lg	拉
lge	拢
lgei	捞
lgeo	擂
lgeu	撩
lgi	览
lgia	撂
lgiae	摞
lgie	掳
lgii	揽
lgo	掠
lgoa	捩
lgoe	挛
lgou	拦
lgoue	搂
lgu	旅
lgua	撸
lgue	旒
lguo	拎
lguoo	捋
lguou	抡
lh	利
lha	礼
lhaa	鹿
lhae	禄
lhe	麓
lhee	卤
lhi	稆
lho	麟
lhoa	稂
lhoe	孪
lhu	囵
lhuo	囹
li	另
lia	戮
liau	叻
lie	啦
liei	喇
lieii	唠
lieiie	嘞
lieiu	啉
lieu	咧
lieua	咙
lieuau	呖
lieui	喱
lieuo	嘹
lieuoa	奁
lii	临
liia	吕
liiae	哩
liiai	啰
lio	喽
lioa	啷
lioae	唳
liu	噜
liuo	呤
lj	令
lja	仂
lje	例
ljei	俩
ljeia	俪
ljeiai	傈
ljeie	佬
ljeu	僚
lji	侣
ljia	儡
ljiae	俚
ljiaee	倮
ljo	偻
lju	伦
ljua	仑
ljue	俐
ljuo	伶
lk	量
lka	勒
lke	辆
lkei	猎
lkeu	獠
lki	狸
lkia	猡
lkie	轳
lko	狼
lkoe	辘
lkoei	晾
lkou	辚
lku	轮
lkua	旯
lkuai	轹
lkuao	辂
lkue	猁
ll	老
lla	垒
lle	魉
lleu	垅
lleua	坜
lli	垆
llia	塄
llo	良
lloe	垃
lloo	墚
llu	黧
lluo	埒
lm	类
lma	娄
lme	姥
lmee	嫠
lmei	婪
lmeia	剌
lmeu	粝
lmi	娌
lmia	嫘
lmo	料
lmoa	粮
lmoe	粒
lmoei	娈
lmoo	粱
lmu	粼
ln	立
lna	辽
lnaa	邋
lnae	逯
lnao	鹨
lne	连
lnei	鹂
lneia	逦
lneu	鹩
lni	逻
lnia	鹭
lnie	鸬
lno	鸾
lnou	遴
lnu	遛
lo	流
loa	卢
loae	漏
loaee	渌
loai	泐
loe	淋
loea	涟
loei	濑
loeia	溧
loeii	涝
loeiu	漤
loeo	涞
loeu	沥
loeua	洌
loeuau	泷
loeuo	潦
loi	泪
loia	潞
loiae	澧
loiaei	漯
loie	滤
loiea	泸
loii	滥
loo	浪
looe	浏
looei	滦
looeu	漓
looeua	漉
looeuo	濂
looi	澜
lou	洛
loua	溜
louai	泺
loue	黎
louo	沦
louoe	潋
louoo	泠
lp	列
lpa	寥
lpe	裂
lpea	裢
lpei	骊
lpeu	寮
lpi	裸
lpia	骡
lpii	褴
lpo	驴
lpou	褛
lpu	牢
lpua	骆
lpuao	骝
lpuo	殓
lpuoe	裣
lq	路
lqa	鬣
lqaa	躐
lqe	霖
lqei	躏
lqeii	崂
lqeo	崃
lqeu	雳
lqi	雷
lqia	露
lqo	屡
lqoa	踉
lqoe	峦
lqou	嶙
lqoue	嵝
lqu	零
lqua	岚
lquai	跞
lquo	岭
lquu	履
lr	理
lre	兰
lrea	琏
lrei	琳
lreu	珑
lri	录
lria	璐
lrie	舻
lrio	隶
lro	灵
lroa	琅
lroe	璃
lroea	琉
lru	玲
lrua	珞
lruo	瓴
ls	里
lsa	虏
lsai	窿
lsau	肋
lse	腊
lseu	胧
lsi	帘
lsia	脶
lsie	胪
lso	虑
lsoa	朗
lsoe	臁
lsoea	羸
lsoeau	膂
lsou	膦
lsu	脸
lsua	乐
lsuau	劣
lsuo	羚
lt	律
lta	碌
lte	磊
ltei	阑
lteo	徕
lteu	砺
lti	闾
lto	硫
ltoa	阆
ltoe	砬
ltou	磷
ltu	砾
lu	乱
lua	卵
luae	箓
lue	笼
luei	籁
lueia	篥
lueu	趔
lui	篮
luia	箩
luo	篱
luoe	笠
luoeu	簏
luou	篓
luu	龄
luua	氇
lv	落
lva	荔
lvao	蓼
lve	莱
lvea	莲
lvei	菱
lveo	蕾
lveu	茏
lveua	苈
lvi	蓝
lvia	萝
lvo	芦
lvoa	莨
lvoe	蓠
lvoi	蔺
lvoo	蒗
lvou	蒌
lvu	莉
lvua	尥
lvue	藜
lvui	莅
lvuo	苓
lvuoe	蔹
lw	力
lwa	醪
lwe	劳
lwei	懒
lweiu	栗
lweu	励
lwi	愣
lwia	醴
lwo	恋
lwoe	懔
lwou	髅
lwu	怜
lwua	酪
lwuo	酹
lx	联
lxe	陆
lxei	陵
lxeia	陋
lxeiao	郦
lxeii	耢
lxeiio	荦
lxeo	酃
lxeu	陇
lxo	郎
lxoo	耒
lxou	耧
lxu	隆
lxua	聊
lxue	犁
lxuo	邻
lxuoo	聆
ly	烈
lye	炼
lyeo	睐
lyeu	燎
lyo	烂
lyoa	炉
lyou	瞵
lyu	敛
lyua	烙
lyuao	熘
lz	领
lze	凌
lzea	鲢
lzei	鲮
lzeia	鲡
lzeii	鳓
lzeu	冽
lzi	鲁
lzia	鲤
lziae	鳢
lzie	颅
lziea	鲈
lzo	凉
lzoe	凛
lzou	鳞
lzu	冷
lzuo	翎
ma	飞
maa	镄
mao	钫
mau	锋
maua	钒
mb	府
mba	废
mbi	扉
mbie	痱
mbo	房
mbu	饭
mbua	疯
mbui	腐
mbuo	番
mbuu	畈
mc	封
mca	氟
mcae	绋
mce	缚
mcee	麸
mceu	绂
mci	绯
mco	纺
mcu	纷
mcua	缝
mcue	繁
mcuo	氛
md	发
mde	梵
mdei	榧
mdeiu	棼
mdo	枋
mdu	反
mdua	枫
mduo	桴
me	罚
mee	蝠
meee	蚨
meeu	罘
mei	甫
meie	蜚
meu	蜂
meue	蝮
meuo	蜉
mf	费
mfe	赋
mfei	赙
mfi	斐
mfie	诽
mfio	讣
mfo	访
mfu	讽
mfuu	贩
mg	方
mga	拂
mgai	邡
mge	扶
mgee	抚
mgu	放
mgui	拊
mh	福
mha	凤
mhaa	匚
mhe	祓
mhi	匪
mhia	馥
mho	凡
mhu	弗
mhua	凫
mhui	艴
mhuo	稃
mi	非
mie	否
miee	呋
mieee	唪
miei	樊
mieu	吠
mii	奋
miie	啡
miu	咐
miuo	吩
mj	佛
mja	孚
mje	付
mjea	伐
mjee	俸
mjei	傅
mjeie	偾
mjeu	伏
mjo	仿
mjoe	俯
mju	份
mjua	孵
mjuo	俘
mk	犯
mka	狒
mke	辅
mkei	辐
ml	复
mlo	坟
mloe	坊
mlou	黼
mloui	黻
mlu	阜
mlui	垡
mm	负
mma	妇
mmae	妃
mme	副
mmei	粪
mmo	妨
mmu	粉
mn	返
mnu	逢
mo	法
moa	沸
moe	沣
moo	涪
moou	瀵
mou	泛
moua	淝
mouo	浮
mouoa	汾
mouou	滏
mp	富
mpu	袱
mpui	驸
mq	峰
mqe	趺
mqi	霏
mqu	跗
mquo	蹯
mr	分
mre	珐
mro	舫
mru	鼢
ms	服
msa	肥
mse	肤
msei	肺
msi	腓
mso	肪
msoe	腑
msu	腹
mt	阀
mta	砩
mte	匐
mtei	砝
mtu	矾
mtua	砜
mu	符
mue	篚
mui	赴
muo	乏
muu	筏
mv	夫
mve	丰
mvee	芙
mvei	芾
mveie	葑
mveu	奉
mvi	菲
mvo	范
mvoe	芳
mvoo	藩
mvu	芬
mvua	菔
mvue	蘩
mvui	苻
mvuie	茯
mvuo	蕃
mvuoo	莩
mw	父
mwa	怫
mwe	愤
mwee	釜
mwi	悱
mwu	覆
mwuo	忿
mwuoa	酚
mwuu	斧
mx	风
mxe	酆
mxi	阝
mxo	防
mxu	附
mxuo	郛
my	烦
mye	焚
myei	敷
myi	缶
myu	烽
myuo	燔
mz	翻
mza	冯
mze	幅
mzei	鲼
mzi	翡
mzie	鲱
mzii	幞
mzo	鲂
mzu	帆
mzue	鳆
mzui	鲋
mzuo	幡
na	巴
naa	鐾
naai	钯
nae	镖
naei	钵
naeu	钚
naeua	钹
naeui	钸
naeuo	锛
nai	钡
nao	镑
naoa	铋
naoe	镳
naoo	镔
nau	铂
nauu	钣
nb	病
nba	疤
nbe	庇
nbee	癍
nbei	饽
nbeia	瘭
nbeu	畀
nbi	扁
nbia	痹
nbo	饼
nbu	饱
nbui	瘪
nbuia	庳
nbuu	瘢
nc	版
nce	绑
nco	编
ncoo	缤
ncou	绊
ncu	绷
ncui	缏
nd	本
nda	檗
nde	标
ndee	棒
ndeee	梆
ndei	柄
ndeiu	彬
ndeu	杯
ndi	步
ndo	榜
ndoo	槟
ndu	板
ndua	杓
ndui	柏
ne	不
nea	辫
nee	罢
neee	蚌
nei	丙
neo	辩
neoa	蝙
neou	辨
neu	百
neuu	瓣
nf	变
nfe	斌
nfei	贲
nfeu	甭
nfi	禀
nfia	亳
nfio	卞
nfo	贝
nfoe	谤
nfu	败
nfui	褒
nfuo	贬
ng	把
nga	报
ngae	摒
ngaeu	擘
ngau	拨
nge	拜
ngei	捕
ngeia	搏
ngeu	拔
ngi	摆
ngia	捌
ngie	彪
ngo	拌
ngoo	摈
ngu	抱
ngui	捭
nguo	播
nguoa	扮
nguoau	掰
nguoo	扒
nguu	搬
nguua	扳
nh	匾
nhe	弼
nhea	秕
nhu	孢
nhui	稗
ni	北
nia	吧
nie	奔
niea	吡
nieau	哔
niei	哺
nii	呗
niia	嘣
niio	卟
nio	啵
niu	叭
nj	保
nje	便
njeu	佰
njo	伴
njoe	倍
njoeo	傍
njoo	傧
nju	伯
njua	豹
njui	俾
nk	白
nka	靶
nke	暴
nkea	狴
nkei	鞴
nkeia	晡
nki	辈
nkia	狈
nkiai	帛
nku	鞭
nl	备
nla	壁
nle	博
nleu	弁
nleua	魃
nleuo	畚
nli	坝
nlia	惫
nlo	孛
nlu	堡
nlui	卑
nluia	埠
nluo	坌
nluu	坂
nm	别
nma	剥
nmae	嬖
nmai	粑
nme	婊
nmea	妣
nmu	婢
nn	边
nna	避
nne	逼
nnei	逋
nneio	鹁
nno	遍
nnou	迸
nnu	鸨
nnui	鹎
no	半
noa	波
noe	渤
noeo	灞
noi	濒
noo	卜
nooe	汴
nooo	滨
nou	浜
noue	滗
noui	濞
np	被
npa	襞
npe	宝
npee	裱
npei	骠
npi	补
npie	褙
npo	殡
npoa	褊
npu	宾
npui	裨
npuii	褓
npuo	驳
nq	霸
nqa	跛
nqai	岜
nqe	跋
nqea	跸
nqeu	豳
nqi	蹦
nqo	鬓
nqoe	踣
nqou	蹩
nqu	崩
nqua	雹
nquao	趵
nquu	髟
nr	并
nra	玻
nrae	璧
nre	甏
nrea	舭
nro	八
nroe	斑
nroeo	瓿
nrou	班
nru	兵
nrua	般
nrue	秉
nrui	舶
nruo	玢
nruu	舨
ns	比
nsa	臂
nse	毕
nsei	脖
nseia	膊
nseiai	膘
nseu	毙
nsi	背
nso	膀
nsoa	毖
nsoo	膑
nsu	胞
nsuo	窆
nt	包
nta	彼
ntaa	勹
nte	闭
ntee	碧
ntei	礴
nti	泵
nto	磅
ntoa	碥
ntoe	碚
ntu	碑
ntuo	砭
nu	笔
nua	匕
nuai	笆
nuau	笾
nue	笨
nuea	筚
nuei	簸
nui	箅
nuo	簿
nuoo	箔
nuu	龅
nuui	篦
nv	表
nva	芭
nvae	薜
nve	苯
nvea	荜
nvei	荸
nveie	菝
nveu	茇
nvo	薄
nvoe	苄
nvoeo	蒡
nvoo	菠
nvou	蔽
nvoui	弊
nvu	苞
nvui	蓓
nvuia	蓖
nvuiae	萆
nvuii	葆
nw	必
nwa	爸
nwe	勃
nwei	悖
nweia	醭
nweu	怖
nwi	悲
nwo	办
nwoe	忭
nwoo	髌
nwou	憋
nwu	愎
nwui	髀
nx	部
nxa	耙
nxau	陂
nxe	邦
nxea	陛
nxei	邴
nxeu	飙
nxi	鼻
nxia	鄙
nxie	邶
nxo	飚
nxu	阪
nxua	飑
ny	爆
nye	炳
nyo	敝
nyoa	煸
nyoe	焙
nyoo	灬
nyu	煲
nz	布
nze	帮
nzee	冫
nzei	鳔
nzeu	鲅
nzi	冰
nzo	鳖
nzoa	鳊
nzu	币
nzua	鲍
nzuo	颁
pa	错
paa	锕
pae	鏊
paei	铒
pai	锷
pao	铵
paoe	锿
paoo	镩
pau	矮
paue	锇
pauo	锉
pauou	矬
pb	欧
pbe	庵
pbee	廒
pbei	饵
pbeia	疴
pbi	餐
pbia	癌
pbie	疵
pbo	瘁
pbu	饿
pbuo	痤
pc	寸
pca	厄
pce	厝
pci	厕
pco	氨
pd	此
pde	村
pdei	材
pdeia	槽
pdo	案
pdoe	榱
pdoo	桉
pdu	枞
pe	而
pee	蚕
peee	螯
peei	螬
pei	才
peie	雌
peii	噩
peu	册
peue	蛾
peuo	丛
pf	儿
pfa	词
pfao	诶
pfe	财
pfee	贰
pfeu	讴
pfi	哀
pfia	赐
pfiae	谔
pfo	谙
pfu	讹
pg	按
pga	挨
pgaa	拗
pgao	掺
pge	措
pgeu	扼
pgeue	捱
pgi	操
pgia	摧
pgiae	撮
pgiaeu	摁
pgo	擦
pgoe	揞
pgoo	撺
pgou	搓
pgu	彩
pguo	挫
ph	存
pha	祠
phe	殴
phi	凹
pho	鹾
phu	鏖
pi	啊
pia	唉
piae	喔
pie	哎
piee	嗷
piei	嘈
pieu	呕
pieua	呃
pieui	嗄
pii	嗯
piie	呲
pio	嚓
pioe	啐
piou	嗌
pioui	噌
piu	奥
piue	哦
piui	噢
piuo	嗳
pj	从
pja	仓
pjae	伺
pje	采
pjee	傲
pjei	佴
pjeu	俺
pji	促
pjia	侧
pjiae	偶
pjiai	催
pjo	爱
pju	俄
pjuo	伧
pk	暗
pke	曹
pkee	猜
pkeee	辏
pkeei	犴
pkeeie	獒
pkeu	轭
pki	皑
pko	鞍
pkoe	猝
pku	昂
pkuo	暧
pl	参
pla	埃
plaa	坳
plao	黪
ple	垩
pleu	埯
plo	黯
pm	刺
pma	婀
pmi	粗
pmia	媪
pmie	粲
pmo	粹
pmou	糍
pmu	娥
pmue	糙
pmuo	嫒
pn	鹅
pne	鸥
pnee	遨
pneu	鹌
pneui	鸸
pni	遏
pnia	鹗
pno	鹚
pnu	迩
po	测
poe	漕
poei	洱
poeu	沤
poi	涔
poo	淙
pooe	淬
pou	澳
pouo	沧
pouoi	汆
pp	安
ppa	骖
ppe	残
ppee	骜
ppei	裁
ppi	殂
ppu	袄
ppui	骢
pq	层
pqa	孱
pqai	屙
pqe	岸
pqeu	蹙
pqo	蹭
pqoa	霭
pqoe	蹴
pqoo	蹿
pqou	蹉
pqoue	嵯
pqu	崔
pque	峨
pqueu	岙
pquo	踩
pquoo	岑
pr	曾
pre	珥
prei	艚
preu	瓯
pri	璨
pria	璀
pro	瓷
proo	琮
pru	舱
prui	璁
pruo	瑷
ps	尔
pse	腠
psi	窜
psia	盎
psiae	腭
pso	肮
psoo	胺
psu	脆
psue	臜
psuo	脞
pt	碍
pte	砹
ptei	礤
pti	徂
pto	磁
ptoe	阏
ptou	磋
ptu	匆
pu	策
pui	篡
puia	囱
puo	辞
puoe	簇
puu	毳
pv	二
pva	皴
pve	藏
pvee	藕
pveu	苊
pvi	草
pvia	萼
pviae	蒽
pvie	茈
pvii	艹
pvo	茨
pvoa	蔼
pvoe	萃
pvoea	蔟
pvu	菜
pvua	蔡
pvuau	葱
pvue	莪
pvuo	艾
pvuoa	苍
pvuou	苁
pw	恶
pwa	惨
pwe	惭
pwei	忖
pweii	醋
pweu	怄
pwi	恩
pwia	愕
pwiau	恻
pwo	慈
pwoe	悴
pwu	懊
pwue	酢
px	阿
pxe	耳
pxee	聱
pxi	鄂
pxia	耦
pxo	聪
pxou	隘
py	灿
pye	熬
pyee	敖
pyu	睬
pyui	爨
pz	次
pze	凑
pzee	鳌
pzeu	鲕
pzi	额
pzia	鳄
pziae	颚
pzo	翠
pzu	翱
qa	钱
qaa	锓
qaae	镪
qae	钳
qaee	锲
qaeei	锖
qaei	銎
qao	锵
qau	钦
qaua	铅
qaue	锹
qauei	钎
qauo	铨
qauoo	钤
qb	庆
qba	瘸
qbe	畦
qbeu	畎
qbi	启
qbia	癯
qbo	欠
qbou	歉
qbu	痊
qc	气
qca	氢
qce	躯
qcee	氰
qceu	绮
qci	缱
qcia	缲
qco	绻
qcoa	綮
qcu	麴
qd	权
qda	劝
qdae	杞
qde	歧
qdea	椠
qdei	棋
qdeia	栖
qdeii	檠
qdeio	樯
qdeu	槭
qdi	桤
qdo	渠
qdoa	榷
qdoo	柒
qdu	枪
qdue	桥
qduee	橇
qduei	楸
qdui	樵
qduo	檎
qe	求
qea	七
qeaa	虬
qee	蜻
qeee	螓
qeei	蛩
qeeii	蜞
qei	瞿
qeia	蛐
qeiae	蛆
qeiaee	蠼
qeo	蜷
qeoe	蛴
qeou	蜣
qeoue	蝤
qeu	蚯
qf	请
qfa	弃
qfai	诎
qfe	謦
qfei	赇
qfi	谴
qfio	诮
qfo	谦
qfu	齐
qfue	讫
qfui	谯
qfuo	诠
qg	旗
qge	擎
qgee	挈
qgi	觑
qgo	拳
qgoa	掮
qgoo	搴
qgu	抢
qgua	掐
qgue	撬
qguee	揿
qguei	扦
qguo	擒
qh	区
qha	祁
qhe	秦
qhea	戕
qhee	圊
qhei	祺
qheie	祛
qheii	麒
qhi	强
qhii	凵
qho	秋
qhou	圈
qhu	祈
qhuo	囚
qi	且
qia	邛
qiao	巯
qie	奇
qiea	巧
qiee	契
qieee	嗪
qieu	戚
qieui	嘁
qii	器
qio	牵
qioa	吣
qiu	呛
qiuo	噙
qiuoa	戗
qj	全
qja	侵
qjao	俟
qje	倾
qjee	倩
qjei	俅
qjeo	佥
qji	企
qjio	俏
qjo	禽
qju	侨
qjue	仟
qk	其
qka	轻
qkaa	綦
qke	晴
qkei	耆
qki	曲
qkia	泉
qkio	鞘
qko	敲
qkoo	犬
qku	期
qkua	欺
qkuaa	犰
qkue	鞒
qkuo	辁
qkuu	犭
ql	去
qla	黢
qle	墙
qlea	堑
qleu	颀
qli	乾
qlo	黥
qlu	千
qluo	黔
qluu	圻
qm	切
qme	妻
qmei	娶
qmeio	嫱
qmo	券
qmu	劁
qmui	糗
qn	亲
qna	妾
qnao	逡
qne	鹊
qnei	逑
qni	遣
qno	遒
qnu	迁
qnua	鸲
qnue	迄
qo	清
qoe	潜
qoea	沏
qoee	浅
qoeee	溱
qoei	漆
qoeii	淇
qoi	泅
qoo	泣
qooa	沁
qou	汽
qoue	汔
qouo	洽
qp	骑
qpa	裙
qpae	襁
qpe	驱
qpei	裘
qpeii	骐
qpo	寝
qpoo	骞
qpooa	褰
qpu	衾
qq	青
qqa	屈
qqae	岂
qqaea	屺
qqe	崎
qqea	跷
qqee	岍
qqei	嵌
qqeia	岐
qqeie	跫
qqeu	岖
qqi	峭
qqo	鬈
qqu	跄
qquo	蹊
qr	前
qre	球
qree	琴
qrei	琪
qreia	酋
qreu	琦
qri	璩
qro	琼
qs	群
qsa	穷
qsaa	羌
qsae	穹
qsao	羟
qse	窃
qsei	窍
qsi	丬
qso	腔
qsoe	虔
qsoeu	脐
qsu	雀
qsua	朐
qsuau	肷
qt	确
qta	阕
qte	砌
qtea	硗
qtee	碛
qtei	磬
qti	衢
qtia	阒
qto	阙
qtoo	磲
qu	起
que	趣
quea	乞
quee	箧
queei	箐
quei	箝
queie	筇
queu	乔
qui	丘
quia	氍
quu	签
quua	趋
quui	龋
quuo	筌
qv	茜
qva	荨
qvae	芎
qvaea	芑
qve	蔷
qvea	萋
qvee	葜
qvei	萁
qvi	葺
qvia	苘
qvie	蘧
qvo	蕲
qvoa	茕
qvoo	蕖
qvu	芹
qvua	芪
qvuau	芡
qvue	荞
qvuei	芊
qvui	亓
qvuo	荃
qvuoo	芩
qw	情
qwa	悛
qwe	勤
qwee	惬
qwei	怯
qweie	悫
qweii	醛
qwi	悄
qwii	悭
qwo	髂
qwou	慊
qwu	恰
qwua	劬
qwue	憩
qwuei	愀
qwui	憔
qwuu	愆
qx	却
qxa	取
qxu	卿
qxua	鼽
qxue	阡
qxui	邱
qxuo	郄
qy	缺
qye	罄
qyu	瞧
qyuo	炝
qz	凄
qze	顷
qzea	翘
qzei	鳍
qzeii	颧
qzu	鳅
ra	钢
raa	钆
rae	钙
raei	钴
raeia	镉
rai	锅
raia	锢
rau	钩
raua	铬
raue	锆
rb	广
rba	庚
rbae	赓
rbe	歌
rbei	庋
rbeii	疳
rbi	痼
rbo	馆
rbu	雇
rbue	疙
rc	给
rca	躬
rce	绀
rcei	绠
rci	纲
rcia	绲
rco	缟
rcu	缑
rd	格
rda	根
rdae	概
rdaei	橄
rde	桂
rdea	柜
rdee	杆
rdei	梗
rdeie	杠
rdeii	柑
rdi	观
rdia	棍
rdio	桄
rdo	棺
rdoe	槁
rdoei	椁
rdu	构
rdua	枸
rdue	梏
rduei	栝
rdui	槔
rduo	桧
re	更
ree	罡
reei	蛄
reeii	罟
rei	丐
reia	蛊
reiae	亘
reiaee	蝈	蜾
reiaei	鬲
reu	蚣
reue	虼
rf	高
rfe	龚
rfei	诖
rfeii	诂
rfi	贵
rfia	裹
rfiae	膏
rfo	该
rfoe	赅
rfu	购
rfua	诡
rfue	诰
rfuo	衮
rfuu	诟
rg	规
rga	掼
rge	挂
rgee	觏
rgei	拱
rgeii	擀
rgi	拐
rgia	掴
rgo	搞
rgoi	搁
rgu	搿
rh	国
rha	弓
rhe	固
rhea	匦
rhee	秆
rhei	毂
rheie	彀
rho	稿
rhu	孤
rhuo	冈
ri	工
ria	功
riae	哏
riau	戤
rie	哥
riei	咕
rieia	哽
rieiae	嗝
rieii	噶
rieu	嘎
rii	贡
riia	汞
riiae	呷
riiau	呙
riii	丨
riio	咣
rio	戈
riu	攻
riua	巩
riuao	咯
riuo	谷
riuu	呱
rj	个
rja	伽
rje	供
rjei	估
rjeio	虢
rjo	瓜
rjoo	倌
rju	傀
rjua	佝
rjue	仡
rk	果
rke	皋
rkee	鞲
rkeei	旰
rkei	轱
rkeiu	杲
rki	革
rkia	猓
rkiae	辊
rko	犷
rku	狗
rkua	轨
rkuai	旮
rkuao	晷
rkuu	皈
rl	各
rle	圭
rlei	埂
rleia	塥
rleii	坩
rli	古
rlia	鼓
rliae	辜
rliaea	嘏
rliaei	埚
rlo	鬼
rloe	垓
rloo	艮
rlu	垢
rlue	圪
rm	刚
rme	姑
rmee	媾
rmi	龟
rmia	剐
rmiai	刿
rmo	割
rmou	糕
rmoua	妫
rmu	刽
rn	过
rne	鹳
rnee	遘
rnei	鸪
rni	贯
rnia	赣
rnu	逛
rnuo	鸽
ro	港
roa	溉
roae	澉
roe	灌
roei	卦
roeii	沽
roeiie	泔
roi	汩
roo	滚
rooo	涫
rou	沟
rouo	淦
rp	官
rpe	冠
rpei	褂
rpeu	寡
rpi	宫
rpu	宄
rpua	袼
rq	跟
rqi	岗
rqia	崮
rqo	崞
rqu	跪
rqua	岣
rr	公
rre	关
rrei	共
rreia	舸
rreii	珙
rreu	馘
rri	归
rru	改
rrui	瑰
rs	光
rsa	尕
rse	肝
rsei	肛
rseia	膈
rseie	臌
rseu	肱
rseuo	尜
rsi	盖
rsio	胱
rso	羔
rsoo	羹
rsu	股
rsua	胳
rsui	盥
rsuu	胍
rt	够
rta	勾
rte	硅
rtee	矸
rtei	闺
rto	磙
rtu	阁
rtua	硌
ru	管
rua	簋
rue	赶
ruee	竿
rueei	篝
ruei	乖
rueia	筻
rueie	箍
rui	刮
ruia	睾
ruo	篙
ruu	鸹
ruua	笱
rv	干
rva	菇
rvae	茛
rvai	菰
rve	甘
rvee	癸
rvei	苷
rvi	葛
rvii	尴
rviii	廾
rvio	觥
rvo	莞
rvoe	藁
rvu	尬
rvua	苟
rvuu	觚
rw	感
rwa	怪
rwaa	惯
rwe	骨
rwee	酐
rwei	恭
rweii	酤
rwi	哿
rwu	骼
rwua	鹘
rx	告
rxe	隔
rxee	耕
rxei	牯
rxo	郭
rxoe	陔
rxou	耿
rxu	聒
rxue	牿
rxuei	郜
ry	故
rya	敢
ryae	炔
rye	罐
ryei	缸
ryeie	瞽
rz	顾
rze	鲑
rzei	鲠
rzeu	鳜
rzi	帼
rzia	鳏
rziae	鲴
rzu	鲧
sa	锐
saa	铷
sao	豌
saoo	鋈
sau	钨
sb	胃
sbe	畏
sbea	饶
sbee	庑
sbei	痦
sbi	瘟
sbo	畹
sbu	饪
sbue	痿
sc	维
sca	尉
scau	纫
sce	绕
scee	绒
sceea	纬
sceu	缛
sco	纹
scoo	绾
scu	纨
sd	武
sda	柔
sde	荣
sdea	桡
sdee	枉
sdei	梧
sdeu	歪
sdeua	杌
sdi	枘
sdo	染
sdoo	榕
sdu	桅
se	五
sea	万
see	融
seei	蛙
seeii	蝾
seeo	蠕
sei	巫
seia	蜗
seiae	蜈
seiai	蚺
seiau	蚋
seo	蚊
seoo	蜿
sf	文
sfa	亡
sfaa	紊
sfe	兀
sfei	诬
sfi	让
sfia	误
sfiae	谓
sfu	认
sfue	诿
sg	握
sga	扔
sgao	揉
sge	扰
sgei	捂
sgeio	挝
sgo	挖
sgoe	攘
sgu	挽
sh	外
sha	委
she	围
shee	囗
shei	辱
sheo	孺
shi	冉
sho	弱
shoe	弯
shoei	穰
shoeia	禳
shou	罔
shu	网
shua	稳
shuo	肉
shuoo	稔
si	我
sie	威
siee	味
sieeu	吴
sieeua	戎
siei	吾
sieia	唔
sieie	哇
sieo	嚅
sieu	戊
sii	喂
sio	嚷
siu	唯
siua	吻
siuaa	呜
siuo	嗡
sj	人
sja	仍
sjai	乳
sjau	仞
sje	伟
sjea	佤
sjee	仁
sjei	伍
sjeii	偌
sjeo	儒
sji	偎
sjii	亻
sjo	位
sjoe	瓤
sjou	伪
sju	任
sjue	侮
sjuee	仵
sjuei	倭
sk	日
ska	鞣
skau	轫
ske	旺
skee	狨
skei	晤
ski	猥
skia	猬
skiae	軎
skiao	辋
sko	皖
sku	晚
skua	软
sl	务
sle	圩
slee	圬
sli	斡
slia	魍
slo	壤
slu	魏
slua	坞
slue	壬
sm	如
sma	娓
smao	婺
smaoa	糅
sme	危
smea	娆
smee	妩
smei	娃
smi	娲
smo	妄
smoo	刃
smooa	婉
smooau	剜
smu	妊
smua	刎
sn	违
sna	毋
snao	鹜
sne	鹉
snu	逶
snue	迕
so	为
soa	汝
soaa	潍
soae	渥
soau	洳
soe	污
soee	汪
soei	卧
soeia	浯
soeie	洼
soeo	濡
soeu	洧
soeue	溽
soi	温
soia	涡
soiae	渭
soiaee	涠
soo	湾
sooe	汶
sooi	润
sooo	溶
soou	沩
sou	沃
sp	完
spa	骛
spai	寤
spe	袜
speo	襦
speu	褥
spu	宛
spua	冗
spue	衽
sq	屋
sqa	韧
sqao	蹂
sqe	崴
sqei	嵘
sqi	韦
sqia	髯
sqiae	韪
sqo	雯
squ	尾
squa	雾
sque	巍
squi	嵬
sr	王
sra	艉
sre	玩
sree	玮
srei	鼯
sri	瑞
sro	望
sroe	玟
sroo	瓦
srooa	琬
sru	瓮
srui	璺
ss	容
sse	肟
ssee	朊
ssi	窝
ssia	腽
sso	腕
ssoo	脘
ssu	肜
st	问
ste	闻
stee	闰
steea	闱
sti	微
sto	往
stoo	碗
stu	勿
stue	硪
stuo	阌
su	入
sua	乌
suae	龌
suao	丸
sue	午
suee	舞
suei	箬
sv	无
sva	蔚
svau	茹
sve	若
svea	荛
svee	苇
sveeu	芜
svei	茸
sveii	葚
sveo	薷
sveu	葳
sveua	蕤
sveue	蓐
svi	未
svia	芮
sviae	莴
sviai	苒
svo	蓉
svoa	蕊
svoe	蕹
svoo	菀
svu	萎
svua	芄
svuau	芴
svui	荏
svuo	蓊
svuu	薇
sw	忘
swa	忍
swae	慰
swe	悟
swee	怃
swei	惹
swi	惘
swo	惋
swu	惟
swue	忤
sx	物
sxe	卫
sxee	阮
sxei	牾
sxeu	阢
sxi	隈
sxu	邬
sy	然
sye	热
syee	炜
syei	焐
syi	睿
syia	煨
syo	熔
syoo	烷
syu	燃
sz	顽
sza	幄
sze	帏
szeo	颥
szeu	鲔
szu	翁
szui	帷
ta	民
taa	锰
taaa	乜
taai	镅
taao	鍪
tae	锚
taei	镆
tai	钼
taia	镘
tao	矛
taoi	钔
taou	镁
tau	铭
taua	铆
tb	麻
tbe	馍
tbei	瘼
tbi	庙
tbia	馒
tbie	靡
tbu	麽
tc	麦
tca	缪
tcae	缗
tce	缅
tci	缈
tcia	缦
tco	縻
tcoo	糸
tcu	绵
td	模
tda	楣
tdaa	杩
tde	檬
tdi	杪
tdo	木
tdu	梅
tdue	枚
tdui	棉
te	面
tea	蚂
teai	蜢
teao	蟊
teaoa	蝥
teaou	蛑
tee	蟒
teei	蟆
teeii	螨
teeiii	蠛
teeiio	蠓
teo	蜜
teoa	螟
teoe	蛮
teoea	虻
tf	谋
tfa	谬
tfaa	氓
tfao	袤
tfe	谟
tfi	亩
tfia	谩
tfo	谜
tfoa	谧
tfu	贸
tg	摩
tga	拇
tgae	抿
tge	描
tgee	抹
tgei	摸
tgeii	摹
tgo	扪
tgu	旄
th	名
the	梦
thee	秣
thei	弭
thi	孟
thiu	秒
tho	秘
thou	麋
thu	穆
thua	弥
thuai	祢
ti	吗
tia	买
tiao	哞
tie	蒙
tiee	呒
tieei	唛
tiei	喵
tii	黾
tio	嘛
tioo	嘧
tiou	咪
tioue	咩
tiu	鸣
tj	们
tja	侔
tje	命
tjei	貘
tjeu	貊
tji	觅
tju	貌
tjua	仫
tk	明
tka	猛
tkaa	犸
tkae	猕
tkai	猸
tke	猫
tkee	昧
tkei	暮
tki	冒
tkia	曼
tko	暝
tku	冕
tkua	昴
tkuai	鞔
tl	么
tla	卖
tlaa	坶
tle	默
tlee	魅
tlei	墨
tleii	墓
tli	埋
tlia	墁
tlie	芈
tlo	魔
tlu	牟
tluu	耄
tm	米
tma	妈
tmaa	姆
tmai	媚
tme	妹
tmei	媒
tmeii	嫫
tmi	免
tmiu	妙
tmo	糜
tmoe	嬷
tmu	娩
tmue	敉
tn	每
tna	鹛
tne	迈
tnei	鹋
tno	母
tnou	迷
tnu	邈
to	没
toa	湄
toae	泯
toe	满
toee	沫
toei	漠
toeia	沔
toeii	漭
toeiio	濛
toeiu	沐
toeu	湎
toi	漫
toia	渺
toiae	汨
toiaei	渑
toiau	淼
too	泌
tooa	溟
tou	浼
toua	泖
tp	马
tpa	寐
tpaa	冖
tpaaa	宀
tpae	袂
tpe	寞
tpei	蓦
tpi	骂
tpia	冥
tpiae	幂
tpo	宓
tpu	殁
tq	密
tqa	嵋
tqae	岷
tqu	霉
tqua	峁
tque	髦
tquo	霾
tr	玛
tra	珉
trai	艋
tre	艨
tri	瑁
tru	玫
ts	美
tse	膜
tsee	皿
tsei	朦
tseu	腼
tsi	盟
tso	脉
tsou	脒
tt	门
tta	码
tte	硭
ttei	礞
tti	闽
tto	磨
ttoa	闷
ttoe	闵
tu	毛
tua	毪
tui	篾
tv	某
tva	茅
tvae	苠
tvao	荬
tve	茂
tvee	茉
tveu	莽
tvi	莫
tvia	苗
tviae	蔓
tviaee	萌	苜
tviai	蔑
tviaii	甍	瞢
tviu	末
tvo	茫
tvoe	芒
tvoeu	蘑
tvoeue	蘼
tvu	藐
tvua	茗
tvuau	茆
tvue	莓
tw	慢
twa	勐
twae	愍
twe	慕
twea	劢
twei	募
tweii	懵
tweiu	懋
two	忙
twoi	悯
twoo	懑
twou	醚
twu	勉
twua	酩
twue	酶
tx	牧
txe	陌
txei	牡
txo	邙
txoe	耱
txu	卯
txue	牦
ty	目
tya	眉
tyae	眠
tyao	眸
tyaoa	瞀
tye	灭
tyei	煤
tyeia	眄
tyeie	睦
tyeii	瞒
tyeiii	瞄
tyi	熳
tyiu	眇
tyo	盲
tyoa	瞑
tyoi	焖
tyou	眯
tyu	敏
tz	幕
tze	颟
tzi	帽
tzia	幔
tziae	鳗
tzu	鳘
va	铁
vae	钛
vaei	钍
vaeo	铽
vai	铜
vaia	钿
vaiae	钽
vaio	镗
vao	锑
vaoo	铊
vaooe	铴
vaou	锬
vb	痛
vba	唐
vbao	瘫
vbau	饧
vbe	田
vbea	饨
vbei	町
vbeii	庹
vbeu	餮
vbi	饕
vbo	痰
vboe	疃
vbu	庭
vbua	疼
vbue	畋
vc	统
vce	厅
vci	躺
vcia	缇
vco	绨
vcu	绦
vd	梯
vda	桶
vdai	椭
vde	橐
vdi	棠
vdia	桐
vdiae	榻
vdio	樘
vdo	檀
vdu	桃
vdue	梃
vduu	柝
ve	屯
vei	螳
veo	蜕
veoe	螗
veu	蜓
veua	蜩
vf	谈
vfe	讨
vfee	亠
vfei	谭
vfi	贴
vfia	亭
vfo	誊
vfu	贪
vg	提
vga	抬
vgao	摊
vgaoi	捅
vge	拓
vgee	抟
vgeeu	掭
vgeu	挞
vgo	探
vgoe	搪
vgu	推
vgua	投
vguao	彤
vguau	掏
vgue	托
vguea	拖
vguei	挺
vguo	挑
vh	同
vhe	团
vhi	凸
vhu	图
vhua	秃
vhuo	祧
vi	头
via	叹
viao	嗵
vie	套
viee	吞
viei	吐
vieio	嚏
vii	鼍
vio	太
vioe	啼
viu	听
viua	啕
viue	唾
vj	他
vja	妥
vje	体
vjei	仝
vji	倘
vjia	氽
vjio	傥
vjo	停
vjoe	僮
vjoo	佗
vju	偷
vjua	佟
vjuae	倜
vjuo	佻
vk	替
vke	昙
vkei	獭
vko	暾
vl	条
vle	土
vlee	坛
vlei	塔
vleii	填
vli	台
vlia	坦
vliae	塌
vlio	堂
vlo	塘
vloo	坨
vlu	坍
vlua	堍
vm	她
vma	粜
vmi	兔
vmia	剔
vmo	糖
vmoe	婷
vmou	剃
vn	通
vna	退
vnau	迢
vni	童
vnia	遢
vno	鸵
vnou	鹈
vnu	逃
vnua	逖
vnue	透
vnuei	廷
vnuo	途
vo	泰
voa	汤
voao	滩
voe	添
voee	涛
voei	潭
voeii	汀
voeu	汰
voi	淌
voia	湍
voiae	溻
voo	涕
vooe	潼
vooeu	溏
vooo	沱
vou	涂
voua	淘
voue	沲
vouo	滔
vouoe	洮
vp	它
vpa	褪
vpao	骀
vpe	驮
vpi	袒
vpia	裼
vpo	驼
vpu	殄
vq	跳
vqa	跆
vqau	髫
vqe	屠
vqei	屉
vqeu	炭
vqi	踏
vqia	踢
vqiae	蹋
vqo	蹄
vqoo	跎
vqu	霆
vqua	趿
vquo	韬
vr	艇
vro	瑭
vru	彖
vs	突
vsa	腿
vsae	臀
vsao	胎
vse	豚
vseu	肽
vsi	膛
vsia	腆
vsiai	羰
vso	脱
vsou	腾
vsoue	滕
vsu	窕
vt	徒
vte	闼
vtei	阗
vti	碳
vto	砣
vtu	砼
vu	甜
vua	笤
vuau	龆
vue	舔
vuea	乇
vuei	箨
vui	筒
vuio	趟
vuo	毯
vuoe	鼗
vv	天
vva	苔
vve	薹
vvea	荑
vvi	茼
vvia	萜
vvo	葶
vvu	藤
vvua	萄
vvuai	菟
vvue	莛
vvuo	荼
vw	态
vwe	忒
vwee	恸
vweei	慝
vweeu	忝
vwei	忑
vweu	酞
vwi	惕
vwia	酮
vwiae	覃
vwiaee	醍
vwie	忐
vwo	悌
vwoe	醣
vwoo	酡
vwu	恬
vwua	骰
vwuo	酴
vx	特
vxa	邰
vxi	耥
vxo	陀
vxou	郯
vxu	陶
vy	烫
vya	烃
vyae	煺
vyao	炱
vyo	瞳
vyu	眺
vz	题
vza	帑
vzao	鲐
vzi	帖
vzia	鳎
vzu	颓
vzua	鲦
wa	幻
wae	镬
wao	镐
waou	钬
wau	铧
waua	锪
wauo	铪
wauoo	锾
wb	户
wba	痕
wbe	癀
wbi	扈
wbia	馄
wbo	戽
wbu	痪
wbui	瘊
wc	红
wci	厚
wcia	缋
wciai	缳
wco	氦
wcu	缓
wcue	纥
wcuo	绘
wcuu	绗
wd	欢
wde	横
wdei	桓
wdo	核
wdoe	杭
wdu	槐
wdua	槲
wdui	桦
wduu	桁
we	或
wea	互
wee	虹
weei	蝴
weeia	蟪
weeiae	蚵
weeii	蠖
weeiie	蚶	蟥
weeu	虺
wei	画
weia	蛔
weu	蝗
weue	蚝
weuo	蛤
wf	话
wfa	贺
wfau	亥
wfe	谎
wfee	讳
wfei	诃
wfeie	讧
wfeu	贿
wfeuo	诙
wfi	毫
wfia	豪
wfiae	亨
wfo	诨
wfu	货
wfue	诲
wg	护
wga	撖
wge	撼
wgeo	攉
wgi	捍
wgia	擐
wgo	挥
wgu	换
wh	和
wha	函
whao	弘
whe	祜
whei	觳
whi	回
whia	祸
whiae	夥
whiai	秽
whiaii	圜
who	孩
whoo	禾
whu	毁
whua	囫
whui	凰
whuu	弧
wi	后
wia	吼
wiaa	喙
wiau	夯
wie	号
wiei	呵
wieii	哄
wieiio	嚆
wieiiu	嗬
wieo	嚯
wieu	喊
wieuo	咴
wii	划
wiia	喝
wiiao	嘿
wiie	唬
wio	哼
wioe	咳
wioei	嚎
wioo	嗨
wiou	豢
wiu	哈
wiua	唤
wiuau	唿
wiui	喉
wiuia	嗥
wiuiu	哗
wiuo	呼
wj	会
wja	侯
wje	合
wjei	何
wjeia	盒
wjeu	瓠
wji	候
wjo	含
wjou	伙
wju	化
wjua	貉
wk	皇
wka	轰
wkae	狠
wke	旱
wkee	昊
wkei	荤
wkeii	獾
wkeiia	猢
wki	晃
wkia	猾
wko	晖
wku	昏
wkua	曷
wkue	皓
wkuea	晦
wkui	猴
wkuo	晗
wkuou	轷
wkuu	狐
wl	华
wle	坏
wlee	魂
wleu	卉
wli	翰
wlie	壑
wlo	黑
wloa	壶
wloe	壕
wlu	堠
wm	好
wme	糊
wmei	劐
wmi	奂
wmia	嬛
wmu	婚
wmui	糇
wn	还
wne	鹕
wnei	鹱
wno	鹤
wnoo	逭
wnu	鹄
wnui	遑
wnuu	逅
wo	海
woa	汉
woae	泓
woai	涵
woe	河
woea	汇
woee	汗
woei	湖
woeia	洹
woeie	鸿
woeii	洪
woeiia	瀚
woeiie	潢
woi	混
woia	滑
woiae	涸
woiaee	灏
woiaei	漶
woiaeu	溷
woiai	洄
woie	滹
woo	浑
wooa	沪
wooau	浒
wooe	濠
wooeu	沆
wooo	浣
wou	活
woua	涣
woue	浩
woui	淮
wouia	湟
wouo	浍
wp	害
wpe	寒
wpee	豁
wpei	宦
wpeu	宏
wpi	褐
wpia	寰
wpo	骇
wpu	罕
wpui	骅
wq	韩
wqe	岵
wqi	踝
wqia	鬟
wqu	霍
wr	黄
wre	环
wree	彗
wrei	瑚
wreii	璜
wri	琥
wro	航
wroa	珲
wru	珩
ws	胡
wsa	虍
wse	辉
wsei	盍
wso	肓
wsoa	鲎
wsoae	黉
wsoe	胲
wsu	虎
wt	很
wta	後
wte	磺
wtee	砉
wtei	阖
wteu	闳
wti	徽
wtia	徊
wto	阂
wtoe	訇
wtu	衡
wtua	阍
wtui	徨
wu	乎
wue	簧
wuo	麾
wuu	笏
wuui	篁
wuuia	篌
wv	花
wva	荭
wvai	菡
wvau	薅
wve	葫
wvei	蕙
wveie	蕻
wveo	藿
wvi	茴
wvia	薨
wvo	荒
wvoe	蒿
wvoo	斛
wvooe	菏
wvu	获
wvui	荷
wvuio	萑
wvuo	荟
wvuu	蘅
ww	怀
wwa	恨
wwae	憨
wwai	隳
wwe	恢
wwee	慧
wwei	惠
wweia	惑
wweiae	恒
wweie	恚
wweii	慌
wweiia	怙	醐
wweiie	酣
wweu	憾
wweui	醢
wwi	患
wwia	悍
wwio	恍
wwo	骸
wwoe	劾
wwu	忽
wwua	惚
wwue	悔
wwui	惶
wwuu	骺
wx	耗
wxe	鼾
wxee	邗
wxei	邯
wxu	隍
wxua	郇
wxuai	齁
wxuo	耠
wy	火
wye	灰
wyei	烘
wyeii	煳
wyi	焊
wyu	煌
wyua	焕
wyuo	烩
wyuoo	焓
wyuou	烀
wz	赫
wza	郝
wze	冱
wzee	顸
wzei	翮
wzi	幌
wzia	颢
wzo	颃
wzoo	鲩
wzu	颌
wzui	鳇
wzuo	颔
xa	乃
xaa	钮
xaae	铌
xaau	钕
xae	镊
xaea	铙
xaei	锘
xai	钠
xau	镍
xaui	鼐
xauo	镎
xb	男
xbe	疟
xbee	疒
xbei	馕
xbu	馁
xc	纳
xca	纽
xcau	氖
xce	耐
xd	难
xde	楠
xdee	柰
xdo	柠
xe	囊
xee	蛲
xeei	蝻
xeu	孬
xf	诺
xfi	讷
xg	拟
xga	扭
xgae	挪
xgaea	搦
xge	挠
xgee	撵
xgei	攮
xgeu	捺
xgi	捏
xgie	拈
xgo	拧
xgu	捻
xgue	旎
xh	内
xha	弩
xhai	衄
xhau	囡
xhaue	孥
xhe	匿
xhu	黏
xi	呢
xia	哪
xiau	呶
xie	奈
xiei	喃
xieia	囔
xieii	嗫
xieiie	喏
xii	呐
xiie	啮
xio	哝
xioo	咛
xj	你
xja	傩
xjae	伲
xje	拿
xjee	佞
xjo	侬
xju	倪
xk	暖
xka	昵
xkai	狃
xkao	猱
xke	辇
xko	狞
xkoe	曩
xku	猊
xl	能
xla	坭
xli	南
xlo	垴
xlu	埝
xm	女
xma	奶
xmae	娜
xmaeu	妮
xmai	妞
xmao	奴
xmaoi	胬
xme	嫩
xmeo	糯
xmi	嬲
xmo	娘
xn	鸟
xno	逆
xo	泥
xoa	溺
xoe	臬
xoi	涅
xoie	淖
xoo	浓
xooo	泞
xp	农
xpa	驽
xpe	宁
xpi	衲
xpo	甯
xpu	袅
xq	尼
xqe	蹑
xqi	尿
xqu	霓
xr	弄
xra	瑙
xs	脑
xsa	脲
xse	虐
xsee	腻
xsei	腩
xsi	肭
xso	脓
xt	闹
xta	碾
xtu	硇
xu	年
xv	孽
xva	艿
xve	廿
xvei	蔫
xveu	萘
xvu	茑
xvui	蘖
xw	念
xwa	努
xwae	怩
xwai	忸
xwau	怒
xwe	懦
xweu	恧
xwo	恼
xwoa	酿
xwu	您
xwui	恁
xx	那
xxa	聂
xxe	耨
xxi	牛
xxia	陧
xxo	聍
xy	睨
xz	凝
xza	赧
xze	颞
xzi	鲇
xzu	鲶
xzui	鲵
ya	铺
yaa	铍
yae	钷
yai	钋
yaii	镤
yao	锫
yaou	镨
yb	疲
yba	癖
ybe	庞
ybea	毗
ybeu	痞
ybo	畔
ybu	疱
ybua	庖
ybuaa	庀
yc	片
yce	缥
ycea	纰
ycu	牌
ycuu	氕
yd	朴
yda	杷
yde	枰
ydea	枇
ydi	榀
ydo	疋
ydu	棚
ye	平
yea	辟
yee	蟛
yeea	蚍
yeei	罴
yeeia	螵
yeo	螃
yeu	丕
yeui	蜱
yeuo	蟠
yf	评
yfa	譬
yfi	烹
yfo	旁
yfoa	谝
yfoe	赔
yfou	谱
yfu	贫
yfui	裒
yg	批
yga	披
ygae	擗
ygao	拚
yge	彭
ygee	捧
ygei	攀
ygeo	抨
ygi	排
ygio	扑
ygo	拼
ygoe	掊
ygou	撇
ygu	拍
ygua	抛
ygue	旆
yh	凭
yhe	圃
yhi	叵
yhu	匹
yhuu	爿
yi	品
yia	噼
yiaa	辔
yie	喷
yiee	匏
yiei	啪
yieia	嘌
yieie	嘭
yieu	呸
yii	噗
yiu	啤
yiua	咆
yiuu	哌
yj	偏
yja	爬
yjae	僻
yje	瓢
yjea	仳
yji	仆
yjia	俜
yjie	俳
yju	佩
yjui	貔
yk	魄
yki	曝
yko	攴
yku	狍
ykuo	皤
yl	培
yla	坡
ylae	圮
yle	坪
ylei	埔
yleu	坯
yli	颦
ylia	鼙
ylu	堋
ylui	埤
ym	判
yma	劈
yme	嫖
ymei	剽
ymi	娉
ymo	婆
ymoe	剖
ymoo	嫔
ymou	姘
ymu	刨
ymui	媲
ymuia	粕
yn	迫
ynu	鹏
ynua	逄
yo	派
yoa	泼
yoe	漂
yoei	浦
yoeia	沛
yoeiae	溥
yoeie	澎
yoi	瀑
yoia	淠
yoo	滂
yoou	泮
you	泡
youe	湃
youi	泊
youii	濮
youo	潘
youoa	湓
yp	骗
ype	襻
ypi	裴
ypo	骈
ypou	袢
ypu	袍
ypuo	殍
yq	跑
yqa	霹
yqe	屁
yqei	蹒
yqi	蹼
yqo	屏
yqoa	蹁
yqoo	霈
yqu	趴
yr	普
yra	甓
yre	叛
yree	琶
yri	盘
yrii	璞
yro	瓶
yru	珀
ys	朋
yse	膨
ysee	琵
ysei	脯
yseu	胚
yso	胖
ysou	胼
ysu	盆
ysui	脾
ysuo	脬
yt	破
yte	砰
ytea	砒
ytei	匍
yti	徘
yto	碰
ytoe	彷
ytu	磐
ytua	硼
yu	篇
yue	笸
yuei	筢
yui	乒
yuie	乓
yuo	氆
yuu	篷
yuuu	丿
yv	皮
yve	颇
yvea	芘
yvei	莆
yveo	苹
yveu	苤
yvo	萍
yvoe	菩
yvoo	蒲
yvooe	蒎
yvu	葡
yvua	蓬
yvui	葩
yw	怕
ywa	配
ywe	票
yweo	怦
ywo	醅
yx	飘
yxe	邳
yxi	聘
yxo	陪
yxoa	犏
yxoe	耪
yxu	鄱
yxua	牝
yxui	郫
yxuia	陴
yy	炮
yye	瞟
yyo	瞥
yyoo	攵
yyu	盼
yyui	睥
yz	帕
yza	帔
yze	鲆
yzi	频
yzo	翩
za	承
zaa	钗
zae	铖
zai	丑
zaia	锄
zaiu	钞
zao	铲
zaoe	铳
zaoo	镲
zau	锤
zaue	锸
zaui	钏
zb	床
zba	巛
zbao	瘳
zbe	畴
zbee	瘛
zbei	馇
zbi	巢
zbia	廛
zbo	畜
zbou	瘥
zbu	痴
zbua	馋
zbue	饬
zbuo	疮
zc	厂
zca	绌
zce	纯
zcei	厨
zci	绰
zco	缠
zcu	绸
zcui	氚
zd	查
zda	橙
zdaa	椽
zdao	杈
zdaoe	柽
zde	楚
zdee	椿
zdei	楮
zdeo	樗
zdeu	橱
zdi	柴
zdo	叉
zdoe	榇
zdoo	檫
zdou	槎
zdu	椎
zdue	杵
zduea	枨
zduei	棰
zdui	槌
ze	虫
zea	丞
zeai	蚩
zeao	蛏
zee	蠢
zeea	虿
zeee	蝽
zeo	蝉
zeoa	雠
zeoe	螭
zeu	雏
zeua	蟾
zeuo	蜍
zf	充
zfe	诚
zfei	谌
zfo	诧
zfu	谄
zfua	谗
zfuo	谶
zg	持
zge	搽
zgi	抽
zgia	揣
zgiae	抻
zgie	扯
zgiei	觇
zgio	撑
zgiu	抄
zgo	撤
zgoe	搐
zgu	插
zgua	搀
zgue	捶
zguee	掣
zguu	拆
zguui	搋
zh	程
zha	弛
zhe	秤
zhea	舛
zhi	臣
zhia	唇
zho	禅
zhoo	辰
zhu	称
zhua	稠
zhuo	鬯
zi	成
zia	戳
ziao	啜
zie	呈
ziei	嘲
zieie	哧
zieii	嗔
zii	唱
ziia	串
ziiae	嘬
ziiai	喘
ziiaie	嗤
ziiu	吵
zio	啻
ziu	吃
ziua	吹
ziuaa	叱
zj	传
zje	豺
zjee	俦
zji	偿
zjia	倡
zjo	储
zjoe	侪
zju	仇
zjua	侈
zjuao	傺
zjue	伥
zk	车
zka	辍
zke	春
zkee	舂
zkei	猹
zkeu	晨
zkeua	晟
zki	昌
zkia	畅
zkiae	猖
zko	昶
zku	晁
zl	处
zla	场
zlae	墀
zlai	黜
zle	城
zli	矗
zlia	埕
zlo	斥
zloe	魑
zlu	坻
zluu	坼
zm	创
zma	刍
zmai	媸
zmi	嫦
zmia	娼
zmo	婵
zmoo	姹
zn	产
zna	迟
zni	逞
znia	遄
zno	鹑
znoo	辶
znu	鸱
zo	沉
zoa	池
zoae	潺
zoai	滁
zoao	澄
zoaoo	汊
zoe	潮
zoeu	臭
zoo	淳
zooe	澈
zooei	澶
zp	察
zpa	初
zpae	骣
zpai	驰
zpao	衩
zpe	宠
zpei	衬
zpeie	褚
zpeu	宸
zpi	骋
zpia	裎
zpu	褫
zq	尺
zqe	踌
zqei	躇
zqeu	蹰
zqi	踹
zqie	踔
zqo	崇
zqoe	躔
zqou	羼
zqu	岔
zque	踟
zr	船
zre	舡
zri	冁
zro	琛
zroe	艟
zs	朝
zsa	肠
zse	差
zsea	穿
zsei	尘
zso	尝
zsoe	膪
zsou	塍
zsu	窗
zt	础
zta	闯
ztao	碜
zte	彻
ztea	砗
ztei	碴
zti	徜
ztia	阊
ztii	彳
zto	阐
zu	超
zua	笞
zue	乘
zuee	筹
zui	川
zuia	龊
zuii	齿
zuio	氅
zuu	趁
zuua	龀
zuuu	篪
zv	出
zva	莼
zve	茬
zveu	蒇
zvi	触
zvia	菖
zvii	亍
zviii	屮
zvo	茺
zvu	茶
zvue	垂
zvuea	苌
zvui	茌
zw	惩
zwa	怊
zwe	怵
zwei	憷
zwi	忡
zwia	酲
zwio	惝
zwo	酬
zwoa	忱
zwoe	醇
zwoeo	憧
zwu	愁
zwua	惆
zwue	忏
zwuea	怅
zwuo	怆
zx	除
zxe	陈
zxei	郴
zxi	耻
zxiu	耖
zxu	陲
zy	炒
zye	敕
zyi	敞
zyia	炽
zyie	焯
zyio	瞠
zyu	瞅
zyua	炊
zyuao	眵
zz	常
zze	翅
zzee	帱
zzi	冲
zzia	鲳
zzo	赤
zzoe	颤
zzoeo	幢
