锁	ba
锶	bai
铯	bau
锼	baui
思	bb
饲	bba
瘙	bbao
馓	bbe
馊	bbu
素	bc
缫	bca
厮	bce
纟	bcee
缌	bci
缩	bco
绥	bcu
松	bd
桑	bda
梭	bdao
森	bde
桫	bdo
叟	bdu
榫	bdui
丝	be
隼	bee
蛳	bei
卅	beu
螋	beui
诉	bf
诵	bfa
谡	bfi
兕	bfia
赛	bfo
谇	bfoe
讼	bfu
损	bg
扫	bga
搔	bgao
搡	bgaoa
撒	bge
撕	bgei
擞	bgo
挲	bgoo
搜	bgu
四	bh
私	bha
祀	bhae
祟	bhai
穗	bhe
穑	bhei
夙	bheu
孙	bhi
飧	bhu
司	bi
嗓	bia
咝	biaa
唆	biao
嘶	bie
嗉	biee
嗽	biei
嗦	bieio
虽	bii
嗣	biia
唢	biio
嗍	bio
嗾	bioe
噻	bioo
嗖	biu
俗	bj
仨	bje
僳	bjei
僧	bjo
伞	bjou
斯	bk
狻	bka
狲	bkai
所	bl
埽	bla
寺	ble
叁	bleu
索	blo
塞	bloo
厶	blooo
丧	blou
塑	bloue
啬	blouei
色	bm
姒	bma
糁	bmao
娑	bmo
嫂	bmu
速	bn
鸶	bna
竦	bne
送	bno
邃	bnoo
遂	bnou
飒	bnu
洒	bo
涩	boa
汜	boae
淞	boe
涑	boei
澌	boeii
泗	boi
濉	boia
溯	boo
溲	bou
死	bp
骚	bpa
宋	bpe
驷	bpi
宿	bpu
岁	bq
霰	bqe
崧	bqei
嵩	bqo
艘	br
巳	bra
瑟	bre
肃	bri
琐	brio
肆	bs
羧	bsa
腮	bsi
臊	bsia
脎	bsu
碎	bt
磉	bta
算	bu
笋	bua
笥	buae
毵	buao
簌	bue
三	bv
苏	bva
萨	bvai
荪	bvaie
蒜	bve
菘	bvei
蔌	bveia
觫	bveiae
蓑	bvo
薮	bvou
荽	bvu
酸	bw
髓	bwe
愫	bwee
悚	bwei
粟	bwo
酥	bwu
怂	bwuo
忪	bwuoa
随	bx
隋	bxe
耜	bxi
隧	bxo
耸	bxu
飕	bxui
散	by
睃	bya
眭	bye
燧	byo
睢	byu
瞍	byui
稣	bz
颡	bza
鳋	bzao
凇	bze
鳃	bzi
颂	bzu
钻	ca
锱	caa
铐	cae
锴	caea
錾	caeai
钶	caei
铿	cai
铠	caia
锟	caiae
锃	caiaee
锞	caiaee2	2
钪	cao
镞	caoe
锎	caoi
款	cb
康	cba
邝	cbai
库	cbe
馈	cbi
甾	cbia
廓	cbo
座	cbu
组	cc
缁	cca
缂	cce
氪	ccei
绔	cceu
紫	cci
尊	cco
纩	ccoe
综	ccoo
缯	ccou
纵	ccu
缵	ccue
仄	ccuo
杂	cd
柯	cde
楷	cdea
框	cdee
楱	cdeee
枯	cdei
栽	cdeie
栲	cdeieu
肯	cdi
棵	cdia
槛	cdii
棕	cdo
梓	cdoe
樽	cdou
再	ce
蚤	cea
蝰	cee
罪	cei
枣	ceia
罾	ceo
蝌	ceu
蛞	ceue
资	cf
责	cfe
谮	cfea
贼	cfee
诓	cfeee
诹	cfei
则	cfi
课	cfia
诅	cfiae
贶	cfiaeu
赀	cfie
訾	cfiei
赠	cfo
赃	cfoe
谘	cfoeu
赞	cfu
亢	cfua
诳	cfuau
卒	cfuo
族	cg
择	cga
拶	cgaa
揆	cgao
扛	cge
揩	cgea
揍	cgee
拷	cgei
挎	cgeu
抠	cgeuo
扣	cgi
捆	cgia
抗	cgo
扩	cgoe
控	cgoo
撙	cgou
括	cgu
攒	cgue
攥	cgueo
子	ch
孔	cha
困	che
匡	chee
祖	chi
租	chia
匮	chiae
稞	chiaee
凯	chiai
匝	chiaii
赜	chii
科	cho
孳	chou
孜	chu
秭	chua
祚	chue
可	ci
咖	cia
叩	ciai
奘	ciaie
口	cie
夸	ciee
哐	cieee
啧	cieei
奎	ciei
咂	cieia
哉	cieie
嗑	cieiea
戡	cieii
左	cieu
臧	cieua
喹	cieuo
嘴	cii
噪	ciia
喟	ciiae
啃	ciie
咔	ciiee
咨	cio
吭	cioe
喀	cioo
嗞	ciou
咱	ciu
咋	ciue
唣	ciui
夼	ciuii
唑	ciuo
哙	ciuoe
作	cj
仔	cja
做	cje
龛	cjei
佐	cjeu
侉	cjeuo
侃	cji
佧	cjie
伉	cjo
倥	cjoo
俎	cju
偬	cjua
侩	cjuo
最	ck
辎	cka
暌	ckao
早	cke
暂	ckea
皂	ckeaa
昆	ckeau
狂	ckee
载	ckei
轲	ckeia
昃	ckeu
哭	cki
旷	cko
昨	cku
昝	ckua
狯	ckuo
在	cl
块	cla
垦	clae
堀	claeu
堪	cle
坷	clei
垮	cleu
克	cli
坤	clia
垲	cliai
增	clo
壳	cloa
坑	cloe
圹	cloeu
魁	cloo
凿	clou
考	clu
坎	clua
坐	cluo
刻	cm
籽	cma
刊	cme
糟	cmei
蒯	cmeii
刳	cmeu
剀	cmi
姿	cmo
糠	cmoe
粢	cmoeu
粽	cmoo
姊	cmu
糌	cmua
造	cn
遭	cne
逵	cnei
遵	cno
迮	cnu
自	co
泽	coa
淄	coaa
卡	coe
渍	coee
溘	coei
溃	coi
渴	coia
澡	coiae
滋	coo
滓	cooo
字	cp
裉	cpa
宗	cpe
寇	cpee
宽	cpei
驵	cpi
骒	cpia
灾	cpo
宰	cpoe
裤	cpoeu
客	cpu
驺	cpua
足	cq
跨	cqe
岢	cqei
跬	cqeie
髡	cqeu
躁	cqi
崽	cqia
髭	cqie
岿	cqiu
踪	cqo
鬃	cqoo
崆	cqooa
嵫	cqou
尻	cqu
躜	cque
兹	cr
琢	cre
珂	crei
夔	creu
琨	cri
甑	cro
瓒	cru
舴	crue
空	cs
窟	csa
窥	cse
盔	cseu
胯	cseuo
窠	csi
胩	csie
脏	cso
喾	csoa
腙	csoo
脍	csu
胙	csue
矿	ct
阚	cta
砸	cte
磕	ctei
阃	cti
阔	cto
闶	ctoe
砍	ctu
走	cu
龈	cua
馗	cuao
筐	cue
簪	cuea
箦	cuee
筘	cuei
纂	cui
篑	cuia
龇	cuie
筷	cuo
趑	cuoe
箜	cuoo
笫	cuu
笮	cuue
趱	cuuei
开	cv
亏	cva
芤	cvai
葵	cvao
苦	cve
蒈	cvea
苛	cvei
莰	cveie
奏	cveu
葬	cveua
蒉	cvi
蕞	cvia
觜	cvie
藻	cvo
蔻	cvoo
总	cw
快	cwa
慨	cwae
恳	cwaee
恐	cwe
勘	cwei
骷	cweii
恺	cwi
髁	cwia
愦	cwiae
悝	cwiaee
醌	cwiaee2	2
悃	cwiaei
醉	cwo
慷	cwoe
恣	cwoeu
髋	cwoo
憎	cwou
怎	cwu
恪	cwua
酷	cwue
忾	cwuee
怍	cwuei
愧	cwui
靠	cx
耔	cxa
鄹	cxe
陬	cxei
阻	cxi
聩	cxia
犒	cxo
邹	cxu
阼	cxue
隗	cxui
郐	cxuo
看	cy
瞰	cya
睽	cyao
烤	cye
眶	cyee
灶	cyei
瞌	cyeie
眍	cyeu
燥	cyi
眦	cyie
炕	cyo
况	cz
鲻	cza
鲰	cze
帻	czee
颗	czi
鲲	czia
颏	czo
鳟	czou
短	da
铎	daa
镫	daao
豆	dae
钝	daea
刁	daee
钉	daei
铛	dai
锝	daia
铞	daiae
镀	dao
镝	daoe
镦	daoei
锭	daoo
钭	daooe
钓	dau
铤	daue
铥	dauei
锻	daui
度	db
癜	dba
癫	dbe
瘩	dbei
痘	dbeia
疔	dbeii
店	dbi
疸	dbia
瘅	dbo
底	dbu
躲	dc
绐	dca
牒	dce
纛	dcee
牍	dcei
缔	dco
氮	dcou
缎	dcu
氡	dcua
缍	dcue
氘	dcui
对	dd
邓	dda
棣	ddae
叠	ddao
杜	dde
栋	ddea
椟	ddei
蛋	ddi
档	ddio
柁	ddo
柢	ddu
椴	ddui
东	de
蝶	dee
蠹	deei
甙	deeii
丁	dei
蚪	deo
雕	deu
调	df
读	dfe
订	dfei
赌	dfeie
谍	dfeii
党	dfi
谠	dfio
帝	dfo
谛	dfoe
赕	dfou
贷	dfu
诋	dfua
诞	dfui
兜	dfuia
打	dg
掇	dga
搭	dge
揲	dgei
觌	dgeia
担	dgi
掉	dgie
挡	dgio
抖	dgo
掂	dgoe
掸	dgou
抵	dgu
捣	dgua
多	dh
殿	dha
凳	dhao
朵	dhe
囤	dhea
祷	dhee
凼	dhi
弹	dho
丹	dhoe
段	dhu
稻	dhuo
大	di
叨	dia
叼	diae
咄	diai
噔	diao
夺	die
吨	diea
戴	diei
嘟	dieie
叮	dieii
喋	dieiie
耷	dieiie2	2
嗒	dieiiu
呆	dieiu
哒	dieu
呔	dieuo
吊	dii
戥	diia
奠	dio
嘀	dioe
啶	dioo
啖	diou
咚	diu
哆	diua
哚	diuae
嗲	diuo
但	dj
貂	dja
代	dje
倒	djea
傣	djee
仃	djei
斗	dji
佃	djia
侗	djiae
低	dju
儋	djua
瓞	djue
的	dk
电	dka
旦	dke
鞑	dkeu
独	dki
靼	dkia
狄	dko
地	dl
堕	dla
埭	dlae
堵	dle
垤	dlea
垫	dlei
黩	dleia
堞	dleii
堤	dli
垌	dlia
坫	dlie
断	dlo
墩	dloe
冬	dloo
堆	dlu
垛	dlua
丢	dlue
黛	dlui
耋	dluu
到	dm
妲	dmi
刂	dmii
妒	dmo
嫡	dmoe
娣	dmou
刀	dmu
剁	dmua
籴	dmuo
道	dn
逮	dna
迨	dnao
达	dne
鸫	dnea
毒	dnee
逗	dnei
端	dni
迪	dnia
递	dno
迭	dnu
遁	dnuu
点	do
沌	doe
渎	doei
滇	doeii
洞	doi
沓	doia
淡	doo
渡	dooe
滴	dooeo
淀	dooo
涤	dou
澹	doua
定	dp
殆	dpa
裰	dpao
宕	dpe
褡	dpei
裆	dpi
歹	dpo
殚	dpou
袋	dpu
岛	dq
蹬	dqa
嶝	dqao
巅	dqe
趸	dqea
岽	dqeai
蹀	dqei
峒	dqi
屌	dqia
蹲	dqo
踱	dqoe
踮	dqoeu
靛	dqoo
跌	dqu
跺	dqua
岱	dqui
蹈	dquo
导	dr
弟	dra
玎	dre
单	dri
典	dria
兑	driae
玷	drie
舵	dro
玳	dru
当	ds
肚	dse
胨	dsea
窦	dsei
胆	dsi
胴	dsia
盗	dso
腚	dsoo
羝	dsu
得	dt
砀	dta
磴	dtao
德	dte
砘	dtea
碡	dtee
待	dtei
碟	dteii
甸	dti
碘	dtia
硐	dtiae
碇	dto
碲	dtoe
礅	dtoei
碉	dtu
砥	dtua
碓	dtui
第	du
笃	dua
氐	duae
簦	duao
等	due
簟	duei
笛	dui
笪	duia
箪	duo
簖	duou
答	duu
篼	duui
登	dv
芏	dve
荡	dvo
蒂	dvoe
菪	dvoo
董	dvu
荻	dvua
萏	dvuau
蔸	dvui
动	dw
怠	dwa
怼	dwao
忉	dwau
懂	dwe
酊	dwei
惰	dweu
悼	dwi
恫	dwia
怛	dwiae
髑	dwiai
惮	dwo
惦	dwoe
憝	dwoei
爹	dwu
骶	dwua
都	dx
陡	dxe
犊	dxei
耵	dxeii
聃	dxi
阽	dxie
耽	dxo
郸	dxou
队	dxu
邸	dxua
敌	dy
瞪	dya
鼎	dyae
灯	dye
炖	dyea
盹	dyeai
焘	dyee
盯	dyei
睹	dyeie
督	dyi
敦	dyo
眈	dyoa
睇	dyou
盾	dyu
煅	dyui
带	dz
顿	dze
冻	dzea
顶	dzei
颠	dzeii
鲽	dzeiie
凋	dzu
鲷	dzua
翟	dzui
书	fa
矧	faa
豉	fae
矢	fao
铈	faoe
铩	fau
铄	faua
钐	fauu
食	fb
扇	fba
饣	fbaa
庶	fbe
蚀	fbi
疝	fbia
痧	fbo
饰	fbu
歃	fbue
瘦	fbui
歙	fbuo
身	fc
绍	fca
纾	fcao
射	fce
厍	fcea
寿	fcee
厦	fceu
绳	fci
绅	fcia
绱	fcio
纱	fciu
缮	fco
绶	fcu
术	fd
双	fda
树	fdao
圣	fde
椹	fdei
枢	fdeu
叔	fdi
梢	fdio
疏	fdo
梳	fdoe
柿	fdoei
槊	fdou
杀	fdu
栅	fdua
栓	fduo
杉	fduu
事	fe
虱	fea
署	fee
螫	feei
束	fei
售	feia
蛸	feio
蛇	feo
蟀	feoe
蟮	feou
爽	feu
蜀	feua
说	ff
试	ffe
诗	ffei
赎	ffeia
誓	ffeie
贳	ffeii
市	ffi
识	ffia
衰	ffiae
孰	ffiaea
讪	ffiai
赏	ffio
商	ffo
谥	ffou
设	ffu
赡	ffua
诜	ffue
谁	ffui
赊	ffuo
谂	ffuoo
手	fg
抒	fga
韶	fgau
摄	fge
拭	fgee
扌	fgeee
捎	fgi
摅	fgie
摔	fgo
擅	fgoe
搠	fgou
施	fgu
授	fguo
拾	fguoe
拴	fguoee
彡	fguu
神	fh
社	fhe
秫	fhei
视	fhi
蜃	fhia
稍	fhio
示	fho
殳	fhoo
礻	fhooo
税	fhou
麝	fhu
黍	fhuo
式	fi
吮	fia
唰	fiae
奢	fie
嗜	fiei
哂	fieia
戍	fieu
哨	fii
呻	fiia
豕	fio
唼	fioe
史	fiu
噬	fiue
啥	fiuo
使	fj
似	fja
什	fje
舍	fjee
舒	fjeei
佘	fjeeiu
畲	fjeeiu2	2
侍	fjei
仕	fjeie
伸	fji
倏	fjiu
受	fjo
舜	fjoa
伤	fju
傻	fjui
是	fk
甚	fka
时	fke
轼	fkee
匙	fkei
晒	fkeia
暑	fkeie
申	fki
曙	fkia
狮	fkiu
狩	fko
输	fku
晌	fkui
猞	fkuo
十	fl
声	fla
士	fle
墅	fli
埘	flia
塾	flo
墒	floe
垧	flu
埏	flui
始	fm
刷	fma
耍	fme
孀	fmeo
娠	fmeu
婶	fmo
嬗	fmoe
剡	fmou
剩	fmu
删	fmua
妁	fmuao
姗	fmuau
姝	fmue
刹	fmuo
适	fn
述	fne
逝	fnei
竖	fni
上	fo
渗	foa
涮	foae
漱	foe
氵	foee
潸	foei
澍	foeie
滠	foeii
沭	foeiu
沙	foi
湿	foia
汕	foiai
涉	foie
淑	foiee
水	foo
深	fooa
沈	fooau
渖	fooo
潲	fou
实	fp
室	fpe
守	fpei
审	fpi
驶	fpia
裳	fpio
裟	fpo
骟	fpoa
殊	fpu
殇	fpue
衫	fpuu
山	fq
霜	fqe
霎	fqo
屎	fqou
属	fqu
跚	fqua
嵊	fque
尸	fquu
首	fr
鼠	fra
兽	fri
舢	fria
艄	frio
艏	fro
珊	fru
少	fs
甩	fsa
盛	fse
尚	fsi
胂	fsia
肾	fsii
善	fso
膻	fsoe
朔	fsou
膳	fsoue
胜	fsu
腧	fsuo
石	ft
硕	fte
闩	ftee
砂	fti
砷	ftia
勺	fto
闪	ftu
失	fu
氏	fua
舌	fue
筮	fuei
筛	fui
筲	fuio
释	fuo
弑	fuoe
笙	fuu
舐	fuua
毹	fuuo
世	fv
蔬	fva
苕	fvau
蓍	fve
薯	fvi
莳	fvia
苫	fvie
菽	fviee
莎	fvo
莘	fvoe
蒴	fvou
升	fvu
芍	fvua
芟	fvuaa
觞	fvue
势	fw
恕	fwa
劭	fwau
慎	fwe
慑	fwei
酾	fweia
恃	fweie
生	fx
邵	fxa
陕	fxe
甥	fxei
鄯	fxo
牲	fxu
数	fy
收	fya
烧	fye
炻	fyeu
省	fyi
熟	fyo
煽	fyoa
熵	fyoe
睡	fyu
煞	fyua
烁	fyuai
眚	fyue
瞬	fyuo
师	fz
鲺	fza
帅	fzi
鲥	fzia
鲨	fzo
鳝	fzou
顺	fzu
赦	fzue
知	ga
镇	gae
铸	gaee
针	gaei
锗	gaeie
钲	gaeiei
钟	gai
镯	gaia
铡	gaiau
钊	gaii
锥	gau
铮	gaua
铢	gaue
锺	gauei
雉	gaui
庄	gb
馔	gba
症	gbe
痔	gbei
痣	gbeie
瘃	gbeu
瘴	gbo
疰	gboe
疹	gbu
瘵	gbua
痄	gbue
畛	gbuo
终	gc
缀	gca
纣	gce
缜	gcei
絷	gceie
织	gci
绽	gco
纸	gcu
绉	gcua
缒	gcui
正	gd
札	gda
杼	gdao
整	gde
桎	gdea
止	gdee
栈	gdeea
榛	gdeee
植	gdei
枝	gdeia
栉	gdeii
楂	gdeiu
杖	gdeu
柘	gdeui
桢	gdi
枳	gdia
棹	gdie
柱	gdo
枕	gdoa
槠	gdoae
桩	gdoe
樟	gdoeo
寨	gdoo
榨	gdooa
株	gdu
橥	gdua
柞	gdue
栀	gduu
置	ge
臻	gea
蛰	gee
蛭	geea
隹	geee
蜇	geei
罩	gei
蛀	geo
蟑	geoe
丈	geu
螽	geua
蛛	geue
蜘	geuee
蚱	geuei
证	gf
诏	gfa
诸	gfe
赘	gfee
贽	gfei
斋	gfeu
诼	gfeua
赈	gfeue
衷	gfi
赚	gfo
谆	gfoe
谪	gfoeo
贮	gfoo
质	gfu
诤	gfua
诌	gfuaa
谵	gfuae
账	gfue
诛	gfuee
诈	gfuei
诊	gfuo
指	gg
招	gga
扎	ggaa
撰	ggae
搌	ggaeu
拙	ggai
拯	ggaia
摺	ggao
擢	ggaoe
找	gge
章	ggei
挚	ggeie
揸	ggeiu
振	ggeu
掌	ggi
捉	ggia
拽	ggiae
撞	ggo
摘	ggoe
拄	ggoee
彰	ggoeo
摭	ggoeu
掷	ggou
执	ggu
挣	ggua
旃	ggue
抓	gguu
折	gguue
种	gh
周	ghe
稹	ghei
祝	ghi
咒	ghia
祯	ghie
祉	ghiei
粥	gho
麈	ghoe
禚	ghou
张	ghu
祗	ghua
秩	ghue
稚	ghui
中	gi
嘱	gia
哲	gie
啭	giea
吱	giei
哳	gieie
喳	gieiu
啄	gieu
战	gii
咤	gio
只	giu
啁	giua
吒	giue
住	gj
值	gje
侄	gjea
债	gjee
斟	gjei
仗	gjeu
侦	gji
仲	gjia
倬	gjie
爪	gjo
伫	gjoo
众	gju
仉	gjua
侏	gjue
豸	gjuu
转	gk
昭	gka
辗	gkae
猪	gke
轾	gkea
辄	gkei
轴	gki
轵	gkia
辙	gko
獐	gkoe
智	gku
旨	gkua
狰	gkuaa
轸	gkuo
斩	gkuu
者	gl
支	gla
坠	glai
至	gle
埴	glei
真	gli
直	glia
址	glie
志	glo
夂	gloo
黹	glou
圳	glu
制	gm
争	gma
詹	gme
召	gmi
妯	gmia
粘	gmie
肇	gmo
嫜	gmoe
这	gn
逐	gne
鸷	gnei
站	gni
遮	gno
鸩	gnoa
鹧	gnoe
追	gnu
之	go
治	goa
涨	goae
濯	goao
沼	goau
浙	goe
滞	goei
渚	goeie
汁	goeii
湛	goeiie
渣	goeiu
涿	goeu
占	goi
桌	goia
卓	goiae
浊	goiaei
浞	goiaei2	2
贞	goiau
沾	goie
浈	goiei
注	goo
漳	gooe
丶	gooo
洲	goou
州	gou
潴	goua
洙	goue
装	gp
褶	gpa
骘	gpai
殖	gpe
骤	gpei
冢	gpeu
宙	gpi
驻	gpo
宅	gpu
骓	gpui
展	gq
震	gqe
崭	gqea
峙	gqei
跖	gqeu
趾	gqi
躅	gqia
昼	gqo
嶂	gqoe
咫	gqoi
踯	gqou
踵	gqu
峥	gqua
踬	gquu
主	gr
甄	gre
舯	gri
舳	gria
舟	gro
帚	groa
璋	groe
珠	gru
彘	grue
珍	gruo
着	gs
妆	gsa
状	gse
窒	gsea
肫	gseai
窀	gseaia
盏	gsee
壮	gsei
肢	gseia
肘	gseio
肿	gsi
盅	gsia
胄	gsiae
朕	gso
膣	gsoo
胀	gsu
脂	gsua
胝	gsuae
窄	gsue
胗	gsuo
征	gt
砖	gte
闸	gti
徵	gtia
砧	gtie
砦	gtiei
斫	gtu
磔	gtua
砟	gtue
长	gu
篆	gua
朱	gue
竺	guee
筑	guei
乍	gueie
箸	gueieu
籀	gueieu2	2
竹	gueiu
箴	gueu
毡	gui
兆	guo
赵	guu
筝	guua
卮	guue
笊	guuu
重	gv
专	gva
荮	gvaa
蒸	gvai
茁	gvaii
著	gve
蓁	gvee
蘸	gvei
芷	gvi
芝	gvo
蔗	gvoe
苎	gvoo
觯	gvou
皱	gvu
茱	gvue
助	gw
怔	gwe
忮	gwei
酎	gweio
忠	gwi
惴	gwia
戆	gwo
酌	gwu
酯	gwua
职	gx
阵	gxe
郅	gxea
齄	gxei
陟	gxi
郑	gxo
障	gxoe
鄣	gxoeo
邾	gxu
政	gy
瞩	gya
致	gye
煮	gyei
照	gyi
烛	gyia
炷	gyo
炸	gyu
睁	gyua
瞻	gyuae
灼	gyuao
炙	gyuaoo
眨	gyuo
准	gz
赭	gze
鲭	gzee
翥	gzei
帜	gzi
颛	gzia
帧	gzie
幛	gzo
帐	gzu
帙	gzue
销	ha
乡	haa
镡	hae
锡	hai
镶	hao
锌	haoe
铉	haoea
镟	haoeau
锈	hau
铣	haue
鑫	hauo
锨	hauu
序	hb
飨	hba
席	hbe
歇	hbi
痫	hbo
痃	hboe
馐	hbou
庠	hboue
饷	hbu
馅	hbua
癣	hbuai
廨	hbuaia
饩	hbue
庥	hbui
欷	hbuo
系	hc
絮	hca
线	hce
续	hcei
绪	hceie
缬	hceiei
绁	hceii
厢	hceiu
缃	hceiuo
细	hci
氙	hcia
绡	hcio
纤	hcu
绚	hcua
绣	hcue
相	hd
栩	hda
榍	hdae
樨	hdaeu
戏	hde
朽	hdea
械	hdee
楔	hdeee
杏	hdi
胥	hdia
枵	hdiae
柙	hdiaee
校	hdo
燮	hdoe
楦	hdoo
析	hdu
橡	hdua
枭	hduao
榭	hdui
檄	hduia
叙	hduo
西	he
雄	hee
虾	heei
蜥	heeiu
辛	hei
蝎	heia
蚬	heiau
蟹	heu
蟓	heua
螅	heui
蟋	heuo
许	hf
讯	hfa
玄	hfaa
诩	hfao
谐	hfe
亵	hfei
享	hfi
襄	hfia
谑	hfie
贤	hfii
袭	hfo
详	hfou
谢	hfu
询	hfua
训	hfui
谖	hfuo
形	hg
须	hge
撷	hgei
觋	hgeiu
挟	hgeo
揎	hgo
旋	hgu
歆	hgua
携	hgui
擤	hguia
掀	hguu
血	hh
秀	hha
禧	hhe
祆	hhee
禊	hheee
香	hhi
匣	hhia
祥	hho
弦	hhoe
夕	hhoo
衅	hhou
凶	hhu
稀	hhuo
向	hi
啸	hia
项	hie
哓	hiea
吓	hiei
嘻	hieie
哮	hieieu
咸	hieu
戌	hieue
嘘	hii
嚣	hiia
嚱	hiie
喧	hio
响	hiu
吸	hiua
兄	hiuaa
嗅	hiui
咻	hiuie
唏	hiuo
信	hj
奚	hja
休	hje
偕	hjea
僖	hjei
侠	hjeo
修	hji
仙	hjia
儇	hjiai
像	hju
貅	hjui
斜	hjuo
显	hk
暇	hka
献	hke
晓	hkea
轩	hkee
鞋	hkei
昔	hkeii
晰	hkeiu
皙	hkeiuo
狭	hkeo
猩	hki
狎	hkia
辖	hko
暄	hkoo
曦	hkou
星	hku
旭	hkua
舄	hkuao
獬	hkuau
獯	hkue
曛	hkuei
靴	hkui
猃	hkuo
昕	hkuu
新	hl
协	hla
馨	hlai
型	hle
黠	hlei
夏	hleu
喜	hli
县	hlia
埙	hliae
墟	hlie
魈	hlio
幸	hlo
欣	hlu
孝	hlua
象	hm
婿	hma
糈	hmai
刑	hme
嬉	hmei
粞	hmeia
削	hmi
籼	hmia
嫌	hmo
娴	hmoi
姓	hmu
媳	hmui
选	hn
迅	hna
巡	hnaa
遐	hnae
逊	hnai
逍	hni
暹	hnia
鹇	hno
邂	hnu
鸺	hnui
下	ho
汛	hoa
浔	hoae
泄	hoe
湘	hoei
潇	hoeii
渫	hoeiie
荥	hoeiio
淅	hoeiu
消	hoi
瀣	hoie
息	hoo
泻	hooa
漩	hooe
泫	hooea
渲	hooo
洗	hou
洵	houa
汐	houao
涎	houi
溴	houia
洫	houiai
溪	houo
汹	houoa
淆	houoe
溆	houoee
浠	houoeu
写	hp
宣	hpe
骁	hpea
袖	hpi
宵	hpio
骧	hpo
宪	hpu
殉	hpua
驯	hpui
需	hq
雪	hqa
霞	hqae
峡	hqe
踅	hqei
屑	hqi
岫	hqia
岘	hqiau
霄	hqio
犀	hqioe
躞	hqo
峋	hqu
跹	hque
跣	hquei
髹	hqui
崤	hquo
屣	hquu
现	hr
瑕	hra
巽	hrae
寻	hre
兮	hrea
巷	hrei
舾	hreia
顼	hreu
璇	hro
舷	hroe
玺	hru
鼷	hrui
学	hs
胁	hsa
羞	hsai
翔	hsao
兴	hse
膝	hsei
虚	hsi
肖	hsia
腥	hsiae
小	hso
泶	hsoa
羡	hsoe
窨	hsoeo
穴	hsoo
胸	hsu
穸	hsua
羲	hsue
腺	hsui
行	ht
闲	hte
硎	htee
硒	htei
硖	hteo
旬	hti
徙	htie
硝	htio
碹	hto
徐	htu
徇	htua
矽	htuao
衔	htue
阋	htui
匈	htuo
循	htuu
笑	hu
箫	hua
箱	hue
囟	hui
筱	huu
筅	huue
些	hv
萧	hva
芗	hvaa
菥	hve
葙	hvei
蕈	hveia
薤	hveu
苋	hvi
葸	hvia
蓄	hvo
芯	hvoa
薪	hvoe
蓿	hvoo
萱	hvooa
薛	hvu
荀	hvua
藓	hvuai
薰	hvue
莶	hvuo
荇	hvuu
蓰	hvuui
心	hw
勰	hwa
醑	hwai
想	hwe
惜	hwei
悻	hweie
醒	hwi
悬	hwia
勋	hwiae
惺	hwiaee
勖	hwiaee2	2
忄	hwii
醯	hwo
性	hwu
懈	hwua
恂	hwuai
酰	hwue
醺	hwuei
恤	hwui
悉	hwuo
酗	hwuoa
忻	hwuu
先	hx
限	hxa
陉	hxao
邪	hxe
邢	hxee
牺	hxei
隙	hxi
隰	hxia
险	hxu
陷	hxua
卸	hxue
郗	hxuo
效	hy
熊	hya
熙	hye
盱	hyee
熹	hyei
燹	hyeu
煦	hyi
罅	hyie
瞎	hyo
眩	hyoe
炫	hyoea
煊	hyoo
熄	hyu
熏	hyue
烯	hyuo
希	hz
习	hza
鲟	hzae
颉	hze
鳕	hzeo
鲜	hzo
鲞	hzou
翕	hzu
冼	hzue
金	ja
键	jaa
钅	jaaa
锯	jaae
锔	jaaeu
畿	jaao
矩	jae
钜	jaea
豇	jaei
铗	jaeo
镢	jaeu
鉴	jai
钾	jaia
卺	jaiau
乩	jaie
亟	jaii
镜	jao
矜	jaoa
铰	jaoe
锏	jaoi
镓	jaoo
锩	jaou
锦	jau
钧	jaua
矫	jaue
镌	jaui
界	jb
痉	jba
瘕	jbae
疖	jbai
痂	jbau
畸	jbe
饯	jbee
馑	jbei
廑	jbeii
肩	jbi
疽	jbia
扃	jbiai
饺	jbo
瘠	jboe
疾	jbu
饥	jbua
疚	jbuao
疥	jbuo
经	jc
纪	jca
厩	jcae
纠	jcai
结	jce
绩	jcee
缰	jcei
缙	jceii
缄	jceu
紧	jci
绢	jcia
缉	jciae
继	jco
绞	jcoe
厥	jcou
缣	jcoue
级	jcu
绝	jcua
绛	jcuao
缴	jcui
机	jd
架	jda
艰	jdae
楗	jdaee
椐	jdaeu
橘	jdao
枷	jdau
桔	jde
槿	jdei
柩	jdeu
橛	jdeuo
椒	jdi
楫	jdia
矍	jdiae
枧	jdiau
杰	jdo
桨	jdoe
榉	jdoo
桊	jdou
极	jdu
鸡	jdua
桀	jduao
桷	jduau
榘	jdue
桕	jdui
检	jduo
集	je
隽	jea
截	jee
戋	jeea
羁	jeei
蛱	jeeo
棘	jei
柬	jeia
雎	jeiae
韭	jeie
焦	jeo
蛟	jeoe
夹	jeou
蚧	jeu
虮	jeua
丌	jeui
就	jf
记	jfa
诀	jfae
赆	jfaeu
谲	jfao
计	jfe
讵	jfea
讲	jfee
贱	jfeea
讦	jfeei
诫	jfeeu
警	jfei
谏	jfeia
诘	jfeie
谨	jfeii
赍	jfeiu
京	jfi
齑	jfie
謇	jfo
谫	jfou
交	jfu
讥	jfua
见	jg
据	jga
掘	jgae
捃	jgaee
抉	jgaeu
技	jge
拒	jgea
拣	jgeaa
捷	jgeae
觐	jgei
拮	jgeie
撅	jgeu
掎	jgeuo
揭	jgi
捐	jgia
攫	jgiae
觊	jgiai
接	jgo
挤	jgoe
搅	jgoo
搛	jgou
竟	jgu
拘	jgua
掬	jguao
揪	jgue
旌	jgueu
挢	jgueuo
捡	jguo
几	jh
巨	jha
冂	jhaa
季	jhai
囝	jhaie
孑	jhaiee
孓	jhaio
弪	jhao
禁	jhe
疆	jhei
秸	jheie
稽	jheu
嵇	jheua
积	jhi
稷	jhia
稼	jho
祭	jhu
麂	jhua
麇	jhue
匠	jhuu
叫	ji
君	jia
唧	jiae
戒	jie
喈	jiea
戟	jiei
咭	jieie
戬	jieii
噤	jieiu
戛	jieu
噘	jieuo
咀	jii
戢	jiia
噱	jiie
奖	jio
哜	jioe
嗟	jiou
嚼	jiu
叽	jiua
咎	jiuao
啾	jiue
噍	jiui
件	jj
仅	jja
假	jjae
健	jjaee
倔	jjaeu
倨	jjaeue
俊	jjao
借	jje
侥	jjea
僭	jjeau
佳	jjei
僵	jjeia
伎	jjeiao
佶	jjeie
儆	jjeii
俱	jji
爵	jjia
偈	jjiae
今	jjo
佼	jjoe
僦	jjoei
倦	jjou
价	jju
介	jjui
僬	jjuio
俭	jjuo
基	jk
晋	jke
臼	jkee
鞯	jkei
獗	jkeu
旧	jki
辑	jkia
晶	jkiae
狙	jkiaee
舅	jkiaei
狷	jkiaei2	2
甲	jkii
较	jko
景	jkoe
獍	jkoeo
狡	jkoeu
皎	jkoeuo
炅	jkou
轿	jku
鞠	jkua
鞫	jkuao
靳	jkuu
即	jl
既	jle
暨	jlea
墼	jlei
坚	jli
吉	jlia
嘉	jliae
兢	jliaeu
斤	jlii
境	jlo
均	jlu
圾	jlua
精	jm
剧	jma
剿	jmaa
糨	jmae
刭	jmao
奸	jme
婕	jmea
婧	jmee
荆	jmei
妓	jmeia
粳	jmeiae
姬	jmeii
剞	jmeu
劂	jmeuo
姐	jmi
娟	jmia
剂	jmo
嫉	jmoe
姣	jmoeu
嫁	jmoo
剪	jmou
剑	jmu
娇	jmue
妗	jmuo
进	jn
建	jna
竣	jnao
迳	jnaoe
迦	jnau
靖	jne
竞	jni
竭	jnia
鹃	jniae
迥	jniai
遽	jnie
迹	jno
鹫	jnoe
鹣	jnou
近	jnu
鸠	jnua
鹪	jnui
济	jo
津	joa
浸	joae
浚	joao
泾	joaoe
江	joe
渐	joea
浇	joeau
酒	joei
洁	joeie
浃	joeo
沮	joi
溅	joia
涓	joiae
浆	joo
涧	jooi
湔	joou
激	jou
汲	joua
洚	jouao
湫	joue
洎	joui
家	jp
驾	jpa
裾	jpae
殛	jpai
骏	jpao
袈	jpau
军	jpe
襟	jpei
寄	jpeu
寂	jpi
骥	jpie
裥	jpo
歼	jpu
驹	jpua
骄	jpue
袷	jpuo
衿	jpuoo
局	jq
峻	jqa
崛	jqae
跽	jqaea
踺	jqaee
踞	jqaeu
跏	jqau
居	jqe
距	jqea
践	jqee
趼	jqeeu
髻	jqei
蹶	jqeu
届	jqi
岬	jqia
靓	jqiau
尽	jqo
跤	jqoe
跻	jqoeu
霁	jqoeuo
嵴	jqoeuo2	2
蹇	jqoo
静	jqu
岌	jqua
峤	jque
鬏	jquei
踽	jqui
屐	jquu
屦	jquui
己	jr
珈	jra
琚	jrae
玦	jraeu
卷	jre
兼	jrea
珏	jree
彐	jreee
瑾	jrei
蠲	jreu
具	jri
舰	jria
冀	jrie
忌	jro
玑	jru
玖	jrua
将	js
姜	jsa
窘	jsae
腱	jsaee
胫	jsao
举	jse
肼	jsee
腈	jseei
脚	jsei
尖	jseu
监	jsi
胛	jsia
羯	jsiae
觉	jso
胶	jsoe
脊	jsoeu
窭	jsou
究	jsu
肌	jsua
窖	jsue
皆	jsui
间	jt
径	jta
街	jte
礓	jtei
碱	jteu
句	jti
碣	jtia
礁	jtu
矶	jtua
阄	jtuai
徼	jtui
硷	jtuo
及	ju
九	jua
毽	juae
赳	juai
久	juao
笳	juau
籍	jue
笺	juee
笄	jueeu
箕	juei
趄	jui
笕	juia
龃	juiae
简	juo
箭	juou
筋	juu
笈	juua
解	jv
节	jva
荩	jvae
葭	jvaei
觖	jvaeu
茎	jvao
茄	jvau
荐	jve
苣	jvea
藉	jvee
菁	jveei
芰	jvei
堇	jveia
荚	jveo
蕨	jveu
击	jvi
菌	jvia
茧	jviae
苴	jviaee
蕺	jviaee2	2
莒	jviaei
角	jvii
蒋	jvo
皲	jvoa
蒺	jvoe
荠	jvoeu
茭	jvoeuo
菅	jvoo
菹	jvooe
茳	jvooee
蒹	jvou
井	jvu
菊	jvua
艽	jvuaa
蓟	jvuai
芨	jvuao
蕉	jvui
芥	jvuo
加	jw
劲	jwa
劫	jwe
恝	jwee
酵	jwei
惧	jwi
贾	jwia
憬	jwiae
醵	jwie
惊	jwo
酱	jwoe
急	jwu
悸	jwue
醮	jwui
骱	jwuo
际	jx
聚	jxa
郡	jxae
犟	jxaea
犍	jxaee
阱	jxe
耩	jxee
鄄	jxei
郏	jxeo
犄	jxeu
飓	jxi
犋	jxia
卩	jxii
郊	jxo
降	jxu
牮	jxui
阶	jxuo
教	jy
烬	jya
救	jye
睫	jyea
炬	jyeae
睛	jyee
敬	jyei
炯	jyi
煎	jyo
眷	jyou
睑	jyu
灸	jyua
敫	jyui
爝	jyuo
决	jz
颈	jza
鲫	jzae
减	jze
鲒	jzei
颊	jzeo
巾	jzi
鲣	jzii
鲸	jzo
鲛	jzoe
鲚	jzoeu
翦	jzou
净	jzu
也	ka
银	kaa
乙	kaaa
钇	kaaaa
钰	kae
钺	kaea
铘	kaeai
肀	kaee
蓥	kaei
铕	kaeu
铀	kai
铟	kaia
予	kao
豫	kaoa
铱	kaoe
镱	kaoeo
镛	kaoeu
镒	kaou
钥	kau
铫	kauo
应	kb
庸	kba
瘾	kbai
饴	kbao
疡	kbau
疣	kbe
欤	kbea
痍	kbeae
痖	kbei
瘗	kbeo
欹	kbeu
邕	kbi
瘿	kbia
痒	kbo
瘀	kboe
饔	kboea
癔	kboeo
欲	kbu
饮	kbua
疫	kbuaa
痈	kbuae
饫	kbue
鹰	kbui
庾	kbuie
瘐	kbuiea
膺	kbuiu
馀	kbuo
原	kc
缘	kca
绎	kcao
严	kce
纭	kcee
纡	kceei
压	kcei
萦	kceii
氩	kceiio
厌	kceu
魇	kceuo
靥	kceuoo
餍	kceuoo2	2
厣	kceuoo3	3
缨	kci
氲	kcia
氤	kciae
氧	kco
牖	kcoa
缢	kcou
约	kcu
雁	kcui
赝	kcuiu
繇	kcuo
样	kd
杨	kda
橼	kdaa
楹	kdau
友	kde
椰	kdei
樾	kdeie
桠	kdeii
椅	kdeu
樱	kdi
杳	kdia
柚	kdiae
又	kdo
疑	kdu
檐	kdua
榆	kduo
一	ke
与	kea
蚴	keaa
夷	keae
蚓	keaea
牙	keai
蛹	keao
弋	keaoo
雅	kee
蚜	keea
萤	keei
蜮	keeia
鼋	keeu
罨	keeuo
螈	keeuu
蝇	kei
蜴	keia
蚰	keiae
蚁	keo
蝣	keoe
蛘	keou
蜒	keu
蝓	keuo
用	kf
育	kfa
雍	kfaa
讠	kfaaa
译	kfao
贻	kfaoi
甬	kfaoia
诒	kfaoia2	2
言	kfe
讶	kfea
尧	kfeau
语	kfei
谳	kfeii
谒	kfi
议	kfo
赢	kfoe
谚	kfoeo
誉	kfoo
谊	kfooa
彦	kfou
夜	kfu
诣	kfua
诱	kfue
亦	kfui
谀	kfuie
谕	kfuo
兖	kfuoa
谣	kfuoo
意	kg
扬	kga
掾	kgaa
音	kge
揶	kgei
揠	kgeia
掩	kgeu
影	kgi
押	kgia
揖	kgiae
挹	kgiaea
撄	kgiau
掖	kgo
摇	kgu
拥	kgua
抑	kguaa
韵	kguao
旖	kgue
援	kguo
觎	kguoe
揄	kguoei
於	kguoo
因	kh
孕	kha
园	khe
圄	khei
圉	kheie
囿	kheu
引	khi
圆	khia
秧	khiae
毅	kho
夤	khoo
鬻	khou
医	khu
移	khua
殷	khuu
员	ki
幽	kia
哟	kiaa
吆	kiaao
呦	kiaaoa
吲	kiae
邑	kiai
右	kie
呀	kiea
咦	kieae
吁	kiee
叶	kiei
噎	kieie
哑	kieii
呓	kieiia
央	kii
咽	kiia
奄	kiiae
喁	kiiaee
哕	kiiai
嘤	kiiau
咬	kio
咏	kioa
奕	kioe
唷	kioea
唁	kioee
噫	kioeo
喑	kioeou
吖	kiou
吟	kiu
咿	kiui
喻	kiuo
以	kj
伊	kja
亿	kjaa
俑	kjao
余	kje
伢	kjea
爰	kjee
俞	kjei
偃	kjeia
龠	kjeiae
俨	kjeii
优	kjeu
佑	kjeui
侑	kjeuia
倚	kjeuo
伛	kjeuoa
攸	kji
俣	kjia
依	kjo
仪	kjou
佯	kjoue
仰	kju
佣	kjua
佚	kjue
舀	kjui
佾	kjuo
由	kk
轧	kka
曜	kkao
狁	kkaou
曳	kkau
轺	kkaui
犹	kke
猿	kkei
辕	kkeie
猗	kkeu
舁	kkeui
映	kki
曰	kkia
鞅	kkiae
禺	kkiai
狱	kko
晕	kkoa
昱	kkoe
狺	kkoee
晏	kkoo
猷	kkou
易	kku
昀	kkua
轶	kkue
晔	kkui
臾	kkuo
狳	kkuoe
业	kl
黝	kla
幺	klaa
垠	klae
圯	klaea
邺	klai
亚	kle
域	klei
垣	kleia
堰	kleiae
堙	kleiai
垭	kleii
茔	kleiio
塬	kleu
袁	kli
埸	klia
懿	klo
壹	kloa
壅	kloe
墉	kloeu
垸	kloo
允	klu
黟	klua
矣	klue
妖	km
妤	kma
姨	kme
妍	kmee
娅	kmei
嫣	kmeie
妪	kmeu
姻	kmi
婴	kmia
娱	kmiae
聿	kmii
嬴	kmo
姚	kmu
肄	kmua
媛	kmuo
刈	kmuoi
运	kn
翊	kna
鹬	knao
远	kne
鸦	knea
迓	kneai
鸢	kneao
迂	knee
莺	knei
遗	kni
遇	knia
鸭	kniae
鸯	kniaeu
鹦	kniau
廴	kno
迎	knu
逸	knua
鸳	knuao
迤	knue
延	knui
邀	knuia
遥	knuo
逾	knuoe
鹞	knuoo
鹆	knuou
义	ko
永	koa
涌	koao
源	koe
沅	koee
滟	koeee
湮	koei
滢	koeii
潆	koeiio
淹	koeu
涯	koeue
油	koi
泱	koia
卣	koiaa
洇	koiae
游	koo
泳	kooa
液	kooe
淤	kooea
瀛	kooeai
演	kooo
洋	koou
溢	kooue
漾	koouee
沿	kou
渔	koua
漪	kouau
丫	koui
渊	kouo
渝	kouoe
瀹	kouoei
淫	kouoo
浴	kouou
沂	kouu
验	kp
驭	kpa
驿	kpao
宇	kpe
寅	kpei
殪	kpeie
宥	kpeu
宜	kpi
宴	kpia
寓	kpiae
殒	kpiaei
殃	kpiaeu
裔	kpiau
衣	kpo
衤	kpoo
裕	kpu
冤	kpua
雨	kq
踊	kqa
峄	kqao
岩	kqe
屿	kqea
岈	kqeai
雩	kqee
崾	kqei
崖	kqeu
崦	kqeuo
韫	kqi
霪	kqo
跃	kqu
嶷	kqua
屹	kque
岳	kqui
峪	kquo
嵛	kquoe
已	kr
益	kre
琊	krea
养	kree
莹	krei
瑛	kreii
异	kreu
鼹	kri
鼬	kria
璎	kriau
玉	kro
琰	krou
舣	krouo
舆	kru
瑜	kruo
珧	kruoe
瑶	kruoo
瑗	kruoou
尹	kruu
有	ks
野	ksa
窈	ksaa
盈	ksau
月	kse
胰	ksea
盂	ksee
腰	ksei
盐	kseie
耀	kseu
腌	kseuo
羊	ksi
虞	ksia
胭	ksiae
刖	ksii
腋	kso
恙	ksoa
臆	ksoe
臃	ksoea
媵	ksou
窑	ksu
腴	ksui
肴	ksuo
窬	ksuoe
窳	ksuu
研	kt
硬	kte
砑	ktea
闫	ktee
衙	ktei
阈	kteia
阉	kteu
砚	kti
阅	kto
匀	ktoe
衍	ktoo
徉	ktou
役	ktu
阎	ktua
御	ktue
徭	ktuo
越	ku
胤	kua
毓	kue
竽	kuee
筠	kuei
龉	kueia
夭	kueu
禹	kui
粤	kuia
釉	kuo
箢	kuoo
爻	kuou
筵	kuu
于	kv
药	kva
艺	kvaa
尢	kvaaa
蕴	kvaae
彝	kvaaeo
荫	kvai
云	kvao
蓣	kvaoa
苡	kvaou
艳	kve
芽	kvea
芸	kvee
芋	kveei
芫	kveeu
英	kvi
茵	kvia
营	kvo
弈	kvoe
菸	kvoea
薏	kvoeo
尤	kvoo
元	kvu
苑	kvua
茚	kvuae
莸	kvuau
莠	kvue
萸	kvui
莜	kvuii
要	kw
爷	kwa
忆	kwaa
幼	kwaao
酏	kwai
勇	kwao
怿	kwaoe
怡	kwaoi
恿	kwaoia
愿	kwe
酝	kwee
酉	kweee
酽	kwei
忧	kweu
恹	kweue
愚	kwi
怏	kwia
愠	kwiae
悒	kwiaea
悦	kwo
恽	kwoa
慵	kwoe
愈	kwu
怨	kwua
悠	kwui
愉	kwuo
院	kx
耶	kxa
郁	kxe
耘	kxee
鄢	kxei
郾	kxeia
鄞	kxeii
阳	kxi
邮	kxia
陨	kxiae
隅	kxiaee
郢	kxiaee2	2
郧	kxiaei
劓	kxii
郓	kxo
印	kxu
阴	kxua
隐	kxuaa
眼	ky
熠	kya
熨	kyae
眙	kyao
炀	kyau
燕	kye
焉	kyei
荧	kyeii
睚	kyeu
烟	kyi
煜	kyia
罂	kyiau
炎	kyo
烊	kyou
焱	kyouu
焰	kyu
眢	kyua
烨	kyui
燠	kyuia
预	kz
冶	kza
鱼	kze
羽	kzee
颐	kzei
鱿	kzeu
翳	kzeue
羿	kzeui
翼	kzi
页	kzo
颜	kzoe
翌	kzoeo
鳙	kzoeu
颖	kzu
颍	kzua
鳐	kzuo
了	la
钌	laa
链	lae
铑	laei
铹	laeii
镭	laeo
铼	laeou
镣	laeu
锣	lai
铝	laia
锂	laiae
镙	laiaei
镰	lao
锒	laoa
銮	laoe
锍	laoea
镧	laoi
鎏	laoo
镂	laou
铃	lau
镏	laua
镥	lauai
锊	lauo
留	lb
疗	lba
累	lbaa
癃	lbai
廖	lbao
癞	lbe
疠	lbea
痨	lbei
瘌	lbeia
戾	lbeu
疬	lbeua
瘰	lbi
廉	lbo
廊	lboa
庐	lboae
廪	lboe
瘘	lbou
略	lbu
瘤	lbua
馏	lbuao
痢	lbue
历	lc
绿	lca
氯	lcae
练	lce
厉	lcea
绫	lcei
缭	lceu
厘	lci
缧	lcia
缆	lcii
缕	lco
缡	lcoe
络	lcu
绺	lcua
纶	lcuo
林	ld
李	lda
棂	ldae
棱	lde
楝	ldei
栳	ldeie
檑	ldeo
枥	ldeu
栊	ldeua
楞	ldi
椤	ldia
栌	ldie
榄	ldii
楼	ldo
榔	ldoa
椋	ldoe
栾	ldoei
檩	ldoeia
榈	ldoi
梁	ldoo
栏	ldou
柳	ldu
榴	ldua
橹	lduai
栎	lduaiu
梨	ldue
柃	lduo
来	le
蠡	lea
辣	lee
蜡	leei
罱	leeii
蛎	leeu
两	lei
丽	leia
吏	leiae
螺	leiaei
螂	leo
詈	leoe
蠃	leoea
蠊	leoeu
罹	leoo
蝼	leou
罗	leu
雒	leua
蜊	leue
蛉	leuo
论	lf
率	lfa
赖	lfe
诔	lfee
垄	lfei
聋	lfeii
赉	lfeo
砻	lfeu
刘	lfi
亮	lfia
吝	lfiae
脔	lfii
龙	lfo
谅	lfoe
斓	lfoi
谰	lfoia
离	lfu
赂	lfua
赁	lfui
六	lfuo
拉	lg
拢	lge
捞	lgei
擂	lgeo
撩	lgeu
览	lgi
撂	lgia
摞	lgiae
掳	lgie
揽	lgii
掠	lgo
捩	lgoa
挛	lgoe
拦	lgou
搂	lgoue
旅	lgu
撸	lgua
旒	lgue
拎	lguo
捋	lguoo
抡	lguou
利	lh
礼	lha
鹿	lhaa
禄	lhae
麓	lhe
卤	lhee
稆	lhi
麟	lho
稂	lhoa
孪	lhoe
囵	lhu
囹	lhuo
另	li
戮	lia
叻	liau
啦	lie
喇	liei
唠	lieii
嘞	lieiie
啉	lieiu
咧	lieu
咙	lieua
呖	lieuau
喱	lieui
嘹	lieuo
奁	lieuoa
临	lii
吕	liia
哩	liiae
啰	liiai
喽	lio
啷	lioa
唳	lioae
噜	liu
呤	liuo
令	lj
仂	lja
例	lje
俩	ljei
俪	ljeia
傈	ljeiai
佬	ljeie
僚	ljeu
侣	lji
儡	ljia
俚	ljiae
倮	ljiaee
偻	ljo
伦	lju
仑	ljua
俐	ljue
伶	ljuo
量	lk
勒	lka
辆	lke
猎	lkei
獠	lkeu
狸	lki
猡	lkia
轳	lkie
狼	lko
辘	lkoe
晾	lkoei
辚	lkou
轮	lku
旯	lkua
轹	lkuai
辂	lkuao
猁	lkue
老	ll
垒	lla
魉	lle
垅	lleu
坜	lleua
垆	lli
塄	llia
良	llo
垃	lloe
墚	lloo
黧	llu
埒	lluo
类	lm
娄	lma
姥	lme
嫠	lmee
婪	lmei
剌	lmeia
粝	lmeu
娌	lmi
嫘	lmia
料	lmo
粮	lmoa
粒	lmoe
娈	lmoei
粱	lmoo
粼	lmu
立	ln
辽	lna
邋	lnaa
逯	lnae
鹨	lnao
连	lne
鹂	lnei
逦	lneia
鹩	lneu
逻	lni
鹭	lnia
鸬	lnie
鸾	lno
遴	lnou
遛	lnu
流	lo
卢	loa
漏	loae
渌	loaee
泐	loai
淋	loe
涟	loea
濑	loei
溧	loeia
涝	loeii
漤	loeiu
涞	loeo
沥	loeu
洌	loeua
泷	loeuau
潦	loeuo
泪	loi
潞	loia
澧	loiae
漯	loiaei
滤	loie
泸	loiea
滥	loii
浪	loo
浏	looe
滦	looei
漓	looeu
漉	looeua
濂	looeuo
澜	looi
洛	lou
溜	loua
泺	louai
黎	loue
沦	louo
潋	louoe
泠	louoo
列	lp
寥	lpa
裂	lpe
裢	lpea
骊	lpei
寮	lpeu
裸	lpi
骡	lpia
褴	lpii
驴	lpo
褛	lpou
牢	lpu
骆	lpua
骝	lpuao
殓	lpuo
裣	lpuoe
路	lq
鬣	lqa
躐	lqaa
霖	lqe
躏	lqei
崂	lqeii
崃	lqeo
雳	lqeu
雷	lqi
露	lqia
屡	lqo
踉	lqoa
峦	lqoe
嶙	lqou
嵝	lqoue
零	lqu
岚	lqua
跞	lquai
岭	lquo
履	lquu
理	lr
兰	lre
琏	lrea
琳	lrei
珑	lreu
录	lri
璐	lria
舻	lrie
隶	lrio
灵	lro
琅	lroa
璃	lroe
琉	lroea
玲	lru
珞	lrua
瓴	lruo
里	ls
虏	lsa
窿	lsai
肋	lsau
腊	lse
胧	lseu
帘	lsi
脶	lsia
胪	lsie
虑	lso
朗	lsoa
臁	lsoe
羸	lsoea
膂	lsoeau
膦	lsou
脸	lsu
乐	lsua
劣	lsuau
羚	lsuo
律	lt
碌	lta
磊	lte
阑	ltei
徕	lteo
砺	lteu
闾	lti
硫	lto
阆	ltoa
砬	ltoe
磷	ltou
砾	ltu
乱	lu
卵	lua
箓	luae
笼	lue
籁	luei
篥	lueia
趔	lueu
篮	lui
箩	luia
篱	luo
笠	luoe
簏	luoeu
篓	luou
龄	luu
氇	luua
落	lv
荔	lva
蓼	lvao
莱	lve
莲	lvea
菱	lvei
蕾	lveo
茏	lveu
苈	lveua
蓝	lvi
萝	lvia
芦	lvo
莨	lvoa
蓠	lvoe
蔺	lvoi
蒗	lvoo
蒌	lvou
莉	lvu
尥	lvua
藜	lvue
莅	lvui
苓	lvuo
蔹	lvuoe
力	lw
醪	lwa
劳	lwe
懒	lwei
栗	lweiu
励	lweu
愣	lwi
醴	lwia
恋	lwo
懔	lwoe
髅	lwou
怜	lwu
酪	lwua
酹	lwuo
联	lx
陆	lxe
陵	lxei
陋	lxeia
郦	lxeiao
耢	lxeii
荦	lxeiio
酃	lxeo
陇	lxeu
郎	lxo
耒	lxoo
耧	lxou
隆	lxu
聊	lxua
犁	lxue
邻	lxuo
聆	lxuoo
烈	ly
炼	lye
睐	lyeo
燎	lyeu
烂	lyo
炉	lyoa
瞵	lyou
敛	lyu
烙	lyua
熘	lyuao
领	lz
凌	lze
鲢	lzea
鲮	lzei
鲡	lzeia
鳓	lzeii
冽	lzeu
鲁	lzi
鲤	lzia
鳢	lziae
颅	lzie
鲈	lziea
凉	lzo
凛	lzoe
鳞	lzou
冷	lzu
翎	lzuo
飞	ma
镄	maa
钫	mao
锋	mau
钒	maua
府	mb
废	mba
扉	mbi
痱	mbie
房	mbo
饭	mbu
疯	mbua
腐	mbui
番	mbuo
畈	mbuu
封	mc
氟	mca
绋	mcae
缚	mce
麸	mcee
绂	mceu
绯	mci
纺	mco
纷	mcu
缝	mcua
繁	mcue
氛	mcuo
发	md
梵	mde
榧	mdei
棼	mdeiu
枋	mdo
反	mdu
枫	mdua
桴	mduo
罚	me
蝠	mee
蚨	meee
罘	meeu
甫	mei
蜚	meie
蜂	meu
蝮	meue
蜉	meuo
费	mf
赋	mfe
赙	mfei
斐	mfi
诽	mfie
讣	mfio
访	mfo
讽	mfu
贩	mfuu
方	mg
拂	mga
邡	mgai
扶	mge
抚	mgee
放	mgu
拊	mgui
福	mh
凤	mha
匚	mhaa
祓	mhe
匪	mhi
馥	mhia
凡	mho
弗	mhu
凫	mhua
艴	mhui
稃	mhuo
非	mi
否	mie
呋	miee
唪	mieee
樊	miei
吠	mieu
奋	mii
啡	miie
咐	miu
吩	miuo
佛	mj
孚	mja
付	mje
伐	mjea
俸	mjee
傅	mjei
偾	mjeie
伏	mjeu
仿	mjo
俯	mjoe
份	mju
孵	mjua
俘	mjuo
犯	mk
狒	mka
辅	mke
辐	mkei
复	ml
坟	mlo
坊	mloe
黼	mlou
黻	mloui
阜	mlu
垡	mlui
负	mm
妇	mma
妃	mmae
副	mme
粪	mmei
妨	mmo
粉	mmu
返	mn
逢	mnu
法	mo
沸	moa
沣	moe
涪	moo
瀵	moou
泛	mou
淝	moua
浮	mouo
汾	mouoa
滏	mouou
富	mp
袱	mpu
驸	mpui
峰	mq
趺	mqe
霏	mqi
跗	mqu
蹯	mquo
分	mr
珐	mre
舫	mro
鼢	mru
服	ms
肥	msa
肤	mse
肺	msei
腓	msi
肪	mso
腑	msoe
腹	msu
阀	mt
砩	mta
匐	mte
砝	mtei
矾	mtu
砜	mtua
符	mu
篚	mue
赴	mui
乏	muo
筏	muu
夫	mv
丰	mve
芙	mvee
芾	mvei
葑	mveie
奉	mveu
菲	mvi
范	mvo
芳	mvoe
藩	mvoo
芬	mvu
菔	mvua
蘩	mvue
苻	mvui
茯	mvuie
蕃	mvuo
莩	mvuoo
父	mw
怫	mwa
愤	mwe
釜	mwee
悱	mwi
覆	mwu
忿	mwuo
酚	mwuoa
斧	mwuu
风	mx
酆	mxe
阝	mxi
防	mxo
附	mxu
郛	mxuo
烦	my
焚	mye
敷	myei
缶	myi
烽	myu
燔	myuo
翻	mz
冯	mza
幅	mze
鲼	mzei
翡	mzi
鲱	mzie
幞	mzii
鲂	mzo
帆	mzu
鳆	mzue
鲋	mzui
幡	mzuo
巴	na
鐾	naa
钯	naai
镖	nae
钵	naei
钚	naeu
钹	naeua
钸	naeui
锛	naeuo
钡	nai
镑	nao
铋	naoa
镳	naoe
镔	naoo
铂	nau
钣	nauu
病	nb
疤	nba
庇	nbe
癍	nbee
饽	nbei
瘭	nbeia
畀	nbeu
扁	nbi
痹	nbia
饼	nbo
饱	nbu
瘪	nbui
庳	nbuia
瘢	nbuu
版	nc
绑	nce
编	nco
缤	ncoo
绊	ncou
绷	ncu
缏	ncui
本	nd
檗	nda
标	nde
棒	ndee
梆	ndeee
柄	ndei
彬	ndeiu
杯	ndeu
步	ndi
榜	ndo
槟	ndoo
板	ndu
杓	ndua
柏	ndui
不	ne
辫	nea
罢	nee
蚌	neee
丙	nei
辩	neo
蝙	neoa
辨	neou
百	neu
瓣	neuu
变	nf
斌	nfe
贲	nfei
甭	nfeu
禀	nfi
亳	nfia
卞	nfio
贝	nfo
谤	nfoe
败	nfu
褒	nfui
贬	nfuo
把	ng
报	nga
摒	ngae
擘	ngaeu
拨	ngau
拜	nge
捕	ngei
搏	ngeia
拔	ngeu
摆	ngi
捌	ngia
彪	ngie
拌	ngo
摈	ngoo
抱	ngu
捭	ngui
播	nguo
扮	nguoa
掰	nguoau
扒	nguoo
搬	nguu
扳	nguua
匾	nh
弼	nhe
秕	nhea
孢	nhu
稗	nhui
北	ni
吧	nia
奔	nie
吡	niea
哔	nieau
哺	niei
呗	nii
嘣	niia
卟	niio
啵	nio
叭	niu
保	nj
便	nje
佰	njeu
伴	njo
倍	njoe
傍	njoeo
傧	njoo
伯	nju
豹	njua
俾	njui
白	nk
靶	nka
暴	nke
狴	nkea
鞴	nkei
晡	nkeia
辈	nki
狈	nkia
帛	nkiai
鞭	nku
备	nl
壁	nla
博	nle
弁	nleu
魃	nleua
畚	nleuo
坝	nli
惫	nlia
孛	nlo
堡	nlu
卑	nlui
埠	nluia
坌	nluo
坂	nluu
别	nm
剥	nma
嬖	nmae
粑	nmai
婊	nme
妣	nmea
婢	nmu
边	nn
避	nna
逼	nne
逋	nnei
鹁	nneio
遍	nno
迸	nnou
鸨	nnu
鹎	nnui
半	no
波	noa
渤	noe
灞	noeo
濒	noi
卜	noo
汴	nooe
滨	nooo
浜	nou
滗	noue
濞	noui
被	np
襞	npa
宝	npe
裱	npee
骠	npei
补	npi
褙	npie
殡	npo
褊	npoa
宾	npu
裨	npui
褓	npuii
驳	npuo
霸	nq
跛	nqa
岜	nqai
跋	nqe
跸	nqea
豳	nqeu
蹦	nqi
鬓	nqo
踣	nqoe
蹩	nqou
崩	nqu
雹	nqua
趵	nquao
髟	nquu
并	nr
玻	nra
璧	nrae
甏	nre
舭	nrea
八	nro
斑	nroe
瓿	nroeo
班	nrou
兵	nru
般	nrua
秉	nrue
舶	nrui
玢	nruo
舨	nruu
比	ns
臂	nsa
毕	nse
脖	nsei
膊	nseia
膘	nseiai
毙	nseu
背	nsi
膀	nso
毖	nsoa
膑	nsoo
胞	nsu
窆	nsuo
包	nt
彼	nta
勹	ntaa
闭	nte
碧	ntee
礴	ntei
泵	nti
磅	nto
碥	ntoa
碚	ntoe
碑	ntu
砭	ntuo
笔	nu
匕	nua
笆	nuai
笾	nuau
笨	nue
筚	nuea
簸	nuei
箅	nui
簿	nuo
箔	nuoo
龅	nuu
篦	nuui
表	nv
芭	nva
薜	nvae
苯	nve
荜	nvea
荸	nvei
菝	nveie
茇	nveu
薄	nvo
苄	nvoe
蒡	nvoeo
菠	nvoo
蔽	nvou
弊	nvoui
苞	nvu
蓓	nvui
蓖	nvuia
萆	nvuiae
葆	nvuii
必	nw
爸	nwa
勃	nwe
悖	nwei
醭	nweia
怖	nweu
悲	nwi
办	nwo
忭	nwoe
髌	nwoo
憋	nwou
愎	nwu
髀	nwui
部	nx
耙	nxa
陂	nxau
邦	nxe
陛	nxea
邴	nxei
飙	nxeu
鼻	nxi
鄙	nxia
邶	nxie
飚	nxo
阪	nxu
飑	nxua
爆	ny
炳	nye
敝	nyo
煸	nyoa
焙	nyoe
灬	nyoo
煲	nyu
布	nz
帮	nze
冫	nzee
鳔	nzei
鲅	nzeu
冰	nzi
鳖	nzo
鳊	nzoa
币	nzu
鲍	nzua
颁	nzuo
错	pa
锕	paa
鏊	pae
铒	paei
锷	pai
铵	pao
锿	paoe
镩	paoo
矮	pau
锇	paue
锉	pauo
矬	pauou
欧	pb
庵	pbe
廒	pbee
饵	pbei
疴	pbeia
餐	pbi
癌	pbia
疵	pbie
瘁	pbo
饿	pbu
痤	pbuo
寸	pc
厄	pca
厝	pce
厕	pci
氨	pco
此	pd
村	pde
材	pdei
槽	pdeia
案	pdo
榱	pdoe
桉	pdoo
枞	pdu
而	pe
蚕	pee
螯	peee
螬	peei
才	pei
雌	peie
噩	peii
册	peu
蛾	peue
丛	peuo
儿	pf
词	pfa
诶	pfao
财	pfe
贰	pfee
讴	pfeu
哀	pfi
赐	pfia
谔	pfiae
谙	pfo
讹	pfu
按	pg
挨	pga
拗	pgaa
掺	pgao
措	pge
扼	pgeu
捱	pgeue
操	pgi
摧	pgia
撮	pgiae
摁	pgiaeu
擦	pgo
揞	pgoe
撺	pgoo
搓	pgou
彩	pgu
挫	pguo
存	ph
祠	pha
殴	phe
凹	phi
鹾	pho
鏖	phu
啊	pi
唉	pia
喔	piae
哎	pie
嗷	piee
嘈	piei
呕	pieu
呃	pieua
嗄	pieui
嗯	pii
呲	piie
嚓	pio
啐	pioe
嗌	piou
噌	pioui
奥	piu
哦	piue
噢	piui
嗳	piuo
从	pj
仓	pja
伺	pjae
采	pje
傲	pjee
佴	pjei
俺	pjeu
促	pji
侧	pjia
偶	pjiae
催	pjiai
爱	pjo
俄	pju
伧	pjuo
暗	pk
曹	pke
猜	pkee
辏	pkeee
犴	pkeei
獒	pkeeie
轭	pkeu
皑	pki
鞍	pko
猝	pkoe
昂	pku
暧	pkuo
参	pl
埃	pla
坳	plaa
黪	plao
垩	ple
埯	pleu
黯	plo
刺	pm
婀	pma
粗	pmi
媪	pmia
粲	pmie
粹	pmo
糍	pmou
娥	pmu
糙	pmue
嫒	pmuo
鹅	pn
鸥	pne
遨	pnee
鹌	pneu
鸸	pneui
遏	pni
鹗	pnia
鹚	pno
迩	pnu
测	po
漕	poe
洱	poei
沤	poeu
涔	poi
淙	poo
淬	pooe
澳	pou
沧	pouo
汆	pouoi
安	pp
骖	ppa
残	ppe
骜	ppee
裁	ppei
殂	ppi
袄	ppu
骢	ppui
层	pq
孱	pqa
屙	pqai
岸	pqe
蹙	pqeu
蹭	pqo
霭	pqoa
蹴	pqoe
蹿	pqoo
蹉	pqou
嵯	pqoue
崔	pqu
峨	pque
岙	pqueu
踩	pquo
岑	pquoo
曾	pr
珥	pre
艚	prei
瓯	preu
璨	pri
璀	pria
瓷	pro
琮	proo
舱	pru
璁	prui
瑷	pruo
尔	ps
腠	pse
窜	psi
盎	psia
腭	psiae
肮	pso
胺	psoo
脆	psu
臜	psue
脞	psuo
碍	pt
砹	pte
礤	ptei
徂	pti
磁	pto
阏	ptoe
磋	ptou
匆	ptu
策	pu
篡	pui
囱	puia
辞	puo
簇	puoe
毳	puu
二	pv
皴	pva
藏	pve
藕	pvee
苊	pveu
草	pvi
萼	pvia
蒽	pviae
茈	pvie
艹	pvii
茨	pvo
蔼	pvoa
萃	pvoe
蔟	pvoea
菜	pvu
蔡	pvua
葱	pvuau
莪	pvue
艾	pvuo
苍	pvuoa
苁	pvuou
恶	pw
惨	pwa
惭	pwe
忖	pwei
醋	pweii
怄	pweu
恩	pwi
愕	pwia
恻	pwiau
慈	pwo
悴	pwoe
懊	pwu
酢	pwue
阿	px
耳	pxe
聱	pxee
鄂	pxi
耦	pxia
聪	pxo
隘	pxou
灿	py
熬	pye
敖	pyee
睬	pyu
爨	pyui
次	pz
凑	pze
鳌	pzee
鲕	pzeu
额	pzi
鳄	pzia
颚	pziae
翠	pzo
翱	pzu
钱	qa
锓	qaa
镪	qaae
钳	qae
锲	qaee
锖	qaeei
銎	qaei
锵	qao
钦	qau
铅	qaua
锹	qaue
钎	qauei
铨	qauo
钤	qauoo
庆	qb
瘸	qba
畦	qbe
畎	qbeu
启	qbi
癯	qbia
欠	qbo
歉	qbou
痊	qbu
气	qc
氢	qca
躯	qce
氰	qcee
绮	qceu
缱	qci
缲	qcia
绻	qco
綮	qcoa
麴	qcu
权	qd
劝	qda
杞	qdae
歧	qde
椠	qdea
棋	qdei
栖	qdeia
檠	qdeii
樯	qdeio
槭	qdeu
桤	qdi
渠	qdo
榷	qdoa
柒	qdoo
枪	qdu
桥	qdue
橇	qduee
楸	qduei
樵	qdui
檎	qduo
求	qe
七	qea
虬	qeaa
蜻	qee
螓	qeee
蛩	qeei
蜞	qeeii
瞿	qei
蛐	qeia
蛆	qeiae
蠼	qeiaee
蜷	qeo
蛴	qeoe
蜣	qeou
蝤	qeoue
蚯	qeu
请	qf
弃	qfa
诎	qfai
謦	qfe
赇	qfei
谴	qfi
诮	qfio
谦	qfo
齐	qfu
讫	qfue
谯	qfui
诠	qfuo
旗	qg
擎	qge
挈	qgee
觑	qgi
拳	qgo
掮	qgoa
搴	qgoo
抢	qgu
掐	qgua
撬	qgue
揿	qguee
扦	qguei
擒	qguo
区	qh
祁	qha
秦	qhe
戕	qhea
圊	qhee
祺	qhei
祛	qheie
麒	qheii
强	qhi
凵	qhii
秋	qho
圈	qhou
祈	qhu
囚	qhuo
且	qi
邛	qia
巯	qiao
奇	qie
巧	qiea
契	qiee
嗪	qieee
戚	qieu
嘁	qieui
器	qii
牵	qio
吣	qioa
呛	qiu
噙	qiuo
戗	qiuoa
全	qj
侵	qja
俟	qjao
倾	qje
倩	qjee
俅	qjei
佥	qjeo
企	qji
俏	qjio
禽	qjo
侨	qju
仟	qjue
其	qk
轻	qka
綦	qkaa
晴	qke
耆	qkei
曲	qki
泉	qkia
鞘	qkio
敲	qko
犬	qkoo
期	qku
欺	qkua
犰	qkuaa
鞒	qkue
辁	qkuo
犭	qkuu
去	ql
黢	qla
墙	qle
堑	qlea
颀	qleu
乾	qli
黥	qlo
千	qlu
黔	qluo
圻	qluu
切	qm
妻	qme
娶	qmei
嫱	qmeio
券	qmo
劁	qmu
糗	qmui
亲	qn
妾	qna
逡	qnao
鹊	qne
逑	qnei
遣	qni
遒	qno
迁	qnu
鸲	qnua
迄	qnue
清	qo
潜	qoe
沏	qoea
浅	qoee
溱	qoeee
漆	qoei
淇	qoeii
泅	qoi
泣	qoo
沁	qooa
汽	qou
汔	qoue
洽	qouo
骑	qp
裙	qpa
襁	qpae
驱	qpe
裘	qpei
骐	qpeii
寝	qpo
骞	qpoo
褰	qpooa
衾	qpu
青	qq
屈	qqa
岂	qqae
屺	qqaea
崎	qqe
跷	qqea
岍	qqee
嵌	qqei
岐	qqeia
跫	qqeie
岖	qqeu
峭	qqi
鬈	qqo
跄	qqu
蹊	qquo
前	qr
球	qre
琴	qree
琪	qrei
酋	qreia
琦	qreu
璩	qri
琼	qro
群	qs
穷	qsa
羌	qsaa
穹	qsae
羟	qsao
窃	qse
窍	qsei
丬	qsi
腔	qso
虔	qsoe
脐	qsoeu
雀	qsu
朐	qsua
肷	qsuau
确	qt
阕	qta
砌	qte
硗	qtea
碛	qtee
磬	qtei
衢	qti
阒	qtia
阙	qto
磲	qtoo
起	qu
趣	que
乞	quea
箧	quee
箐	queei
箝	quei
筇	queie
乔	queu
丘	qui
氍	quia
签	quu
趋	quua
龋	quui
筌	quuo
茜	qv
荨	qva
芎	qvae
芑	qvaea
蔷	qve
萋	qvea
葜	qvee
萁	qvei
葺	qvi
苘	qvia
蘧	qvie
蕲	qvo
茕	qvoa
蕖	qvoo
芹	qvu
芪	qvua
芡	qvuau
荞	qvue
芊	qvuei
亓	qvui
荃	qvuo
芩	qvuoo
情	qw
悛	qwa
勤	qwe
惬	qwee
怯	qwei
悫	qweie
醛	qweii
悄	qwi
悭	qwii
髂	qwo
慊	qwou
恰	qwu
劬	qwua
憩	qwue
愀	qwuei
憔	qwui
愆	qwuu
却	qx
取	qxa
卿	qxu
鼽	qxua
阡	qxue
邱	qxui
郄	qxuo
缺	qy
罄	qye
瞧	qyu
炝	qyuo
凄	qz
顷	qze
翘	qzea
鳍	qzei
颧	qzeii
鳅	qzu
钢	ra
钆	raa
钙	rae
钴	raei
镉	raeia
锅	rai
锢	raia
钩	rau
铬	raua
锆	raue
广	rb
庚	rba
赓	rbae
歌	rbe
庋	rbei
疳	rbeii
痼	rbi
馆	rbo
雇	rbu
疙	rbue
给	rc
躬	rca
绀	rce
绠	rcei
纲	rci
绲	rcia
缟	rco
缑	rcu
格	rd
根	rda
概	rdae
橄	rdaei
桂	rde
柜	rdea
杆	rdee
梗	rdei
杠	rdeie
柑	rdeii
观	rdi
棍	rdia
桄	rdio
棺	rdo
槁	rdoe
椁	rdoei
构	rdu
枸	rdua
梏	rdue
栝	rduei
槔	rdui
桧	rduo
更	re
罡	ree
蛄	reei
罟	reeii
丐	rei
蛊	reia
亘	reiae
蝈	reiaee
蜾	reiaee2	2
鬲	reiaei
蚣	reu
虼	reue
高	rf
龚	rfe
诖	rfei
诂	rfeii
贵	rfi
裹	rfia
膏	rfiae
该	rfo
赅	rfoe
购	rfu
诡	rfua
诰	rfue
衮	rfuo
诟	rfuu
规	rg
掼	rga
挂	rge
觏	rgee
拱	rgei
擀	rgeii
拐	rgi
掴	rgia
搞	rgo
搁	rgoi
搿	rgu
国	rh
弓	rha
固	rhe
匦	rhea
秆	rhee
毂	rhei
彀	rheie
稿	rho
孤	rhu
冈	rhuo
工	ri
功	ria
哏	riae
戤	riau
哥	rie
咕	riei
哽	rieia
嗝	rieiae
噶	rieii
嘎	rieu
贡	rii
汞	riia
呷	riiae
呙	riiau
丨	riii
咣	riio
戈	rio
攻	riu
巩	riua
咯	riuao
谷	riuo
呱	riuu
个	rj
伽	rja
供	rje
估	rjei
虢	rjeio
瓜	rjo
倌	rjoo
傀	rju
佝	rjua
仡	rjue
果	rk
皋	rke
鞲	rkee
旰	rkeei
轱	rkei
杲	rkeiu
革	rki
猓	rkia
辊	rkiae
犷	rko
狗	rku
轨	rkua
旮	rkuai
晷	rkuao
皈	rkuu
各	rl
圭	rle
埂	rlei
塥	rleia
坩	rleii
古	rli
鼓	rlia
辜	rliae
嘏	rliaea
埚	rliaei
鬼	rlo
垓	rloe
艮	rloo
垢	rlu
圪	rlue
刚	rm
姑	rme
媾	rmee
龟	rmi
剐	rmia
刿	rmiai
割	rmo
糕	rmou
妫	rmoua
刽	rmu
过	rn
鹳	rne
遘	rnee
鸪	rnei
贯	rni
赣	rnia
逛	rnu
鸽	rnuo
港	ro
溉	roa
澉	roae
灌	roe
卦	roei
沽	roeii
泔	roeiie
汩	roi
滚	roo
涫	rooo
沟	rou
淦	rouo
官	rp
冠	rpe
褂	rpei
寡	rpeu
宫	rpi
宄	rpu
袼	rpua
跟	rq
岗	rqi
崮	rqia
崞	rqo
跪	rqu
岣	rqua
公	rr
关	rre
共	rrei
舸	rreia
珙	rreii
馘	rreu
归	rri
改	rru
瑰	rrui
光	rs
尕	rsa
肝	rse
肛	rsei
膈	rseia
臌	rseie
肱	rseu
尜	rseuo
盖	rsi
胱	rsio
羔	rso
羹	rsoo
股	rsu
胳	rsua
盥	rsui
胍	rsuu
够	rt
勾	rta
硅	rte
矸	rtee
闺	rtei
磙	rto
阁	rtu
硌	rtua
管	ru
簋	rua
赶	rue
竿	ruee
篝	rueei
乖	ruei
筻	rueia
箍	rueie
刮	rui
睾	ruia
篙	ruo
鸹	ruu
笱	ruua
干	rv
菇	rva
茛	rvae
菰	rvai
甘	rve
癸	rvee
苷	rvei
葛	rvi
尴	rvii
廾	rviii
觥	rvio
莞	rvo
藁	rvoe
尬	rvu
苟	rvua
觚	rvuu
感	rw
怪	rwa
惯	rwaa
骨	rwe
酐	rwee
恭	rwei
酤	rweii
哿	rwi
骼	rwu
鹘	rwua
告	rx
隔	rxe
耕	rxee
牯	rxei
郭	rxo
陔	rxoe
耿	rxou
聒	rxu
牿	rxue
郜	rxuei
故	ry
敢	rya
炔	ryae
罐	rye
缸	ryei
瞽	ryeie
顾	rz
鲑	rze
鲠	rzei
鳜	rzeu
帼	rzi
鳏	rzia
鲴	rziae
鲧	rzu
锐	sa
铷	saa
豌	sao
鋈	saoo
钨	sau
胃	sb
畏	sbe
饶	sbea
庑	sbee
痦	sbei
瘟	sbi
畹	sbo
饪	sbu
痿	sbue
维	sc
尉	sca
纫	scau
绕	sce
绒	scee
纬	sceea
缛	sceu
纹	sco
绾	scoo
纨	scu
武	sd
柔	sda
荣	sde
桡	sdea
枉	sdee
梧	sdei
歪	sdeu
杌	sdeua
枘	sdi
染	sdo
榕	sdoo
桅	sdu
五	se
万	sea
融	see
蛙	seei
蝾	seeii
蠕	seeo
巫	sei
蜗	seia
蜈	seiae
蚺	seiai
蚋	seiau
蚊	seo
蜿	seoo
文	sf
亡	sfa
紊	sfaa
兀	sfe
诬	sfei
让	sfi
误	sfia
谓	sfiae
认	sfu
诿	sfue
握	sg
扔	sga
揉	sgao
扰	sge
捂	sgei
挝	sgeio
挖	sgo
攘	sgoe
挽	sgu
外	sh
委	sha
围	she
囗	shee
辱	shei
孺	sheo
冉	shi
弱	sho
弯	shoe
穰	shoei
禳	shoeia
罔	shou
网	shu
稳	shua
肉	shuo
稔	shuoo
我	si
威	sie
味	siee
吴	sieeu
戎	sieeua
吾	siei
唔	sieia
哇	sieie
嚅	sieo
戊	sieu
喂	sii
嚷	sio
唯	siu
吻	siua
呜	siuaa
嗡	siuo
人	sj
仍	sja
乳	sjai
仞	sjau
伟	sje
佤	sjea
仁	sjee
伍	sjei
偌	sjeii
儒	sjeo
偎	sji
亻	sjii
位	sjo
瓤	sjoe
伪	sjou
任	sju
侮	sjue
仵	sjuee
倭	sjuei
日	sk
鞣	ska
轫	skau
旺	ske
狨	skee
晤	skei
猥	ski
猬	skia
軎	skiae
辋	skiao
皖	sko
晚	sku
软	skua
务	sl
圩	sle
圬	slee
斡	sli
魍	slia
壤	slo
魏	slu
坞	slua
壬	slue
如	sm
娓	sma
婺	smao
糅	smaoa
危	sme
娆	smea
妩	smee
娃	smei
娲	smi
妄	smo
刃	smoo
婉	smooa
剜	smooau
妊	smu
刎	smua
违	sn
毋	sna
鹜	snao
鹉	sne
逶	snu
迕	snue
为	so
汝	soa
潍	soaa
渥	soae
洳	soau
污	soe
汪	soee
卧	soei
浯	soeia
洼	soeie
濡	soeo
洧	soeu
溽	soeue
温	soi
涡	soia
渭	soiae
涠	soiaee
湾	soo
汶	sooe
润	sooi
溶	sooo
沩	soou
沃	sou
完	sp
骛	spa
寤	spai
袜	spe
襦	speo
褥	speu
宛	spu
冗	spua
衽	spue
屋	sq
韧	sqa
蹂	sqao
崴	sqe
嵘	sqei
韦	sqi
髯	sqia
韪	sqiae
雯	sqo
尾	squ
雾	squa
巍	sque
嵬	squi
王	sr
艉	sra
玩	sre
玮	sree
鼯	srei
瑞	sri
望	sro
玟	sroe
瓦	sroo
琬	srooa
瓮	sru
璺	srui
容	ss
肟	sse
朊	ssee
窝	ssi
腽	ssia
腕	sso
脘	ssoo
肜	ssu
问	st
闻	ste
闰	stee
闱	steea
微	sti
往	sto
碗	stoo
勿	stu
硪	stue
阌	stuo
入	su
乌	sua
龌	suae
丸	suao
午	sue
舞	suee
箬	suei
无	sv
蔚	sva
茹	svau
若	sve
荛	svea
苇	svee
芜	sveeu
茸	svei
葚	sveii
薷	sveo
葳	sveu
蕤	sveua
蓐	sveue
未	svi
芮	svia
莴	sviae
苒	sviai
蓉	svo
蕊	svoa
蕹	svoe
菀	svoo
萎	svu
芄	svua
芴	svuau
荏	svui
蓊	svuo
薇	svuu
忘	sw
忍	swa
慰	swae
悟	swe
怃	swee
惹	swei
惘	swi
惋	swo
惟	swu
忤	swue
物	sx
卫	sxe
阮	sxee
牾	sxei
阢	sxeu
隈	sxi
邬	sxu
然	sy
热	sye
炜	syee
焐	syei
睿	syi
煨	syia
熔	syo
烷	syoo
燃	syu
顽	sz
幄	sza
帏	sze
颥	szeo
鲔	szeu
翁	szu
帷	szui
民	ta
锰	taa
乜	taaa
镅	taai
鍪	taao
锚	tae
镆	taei
钼	tai
镘	taia
矛	tao
钔	taoi
镁	taou
铭	tau
铆	taua
麻	tb
馍	tbe
瘼	tbei
庙	tbi
馒	tbia
靡	tbie
麽	tbu
麦	tc
缪	tca
缗	tcae
缅	tce
缈	tci
缦	tcia
縻	tco
糸	tcoo
绵	tcu
模	td
楣	tda
杩	tdaa
檬	tde
杪	tdi
木	tdo
梅	tdu
枚	tdue
棉	tdui
面	te
蚂	tea
蜢	teai
蟊	teao
蝥	teaoa
蛑	teaou
蟒	tee
蟆	teei
螨	teeii
蠛	teeiii
蠓	teeiio
蜜	teo
螟	teoa
蛮	teoe
虻	teoea
谋	tf
谬	tfa
氓	tfaa
袤	tfao
谟	tfe
亩	tfi
谩	tfia
谜	tfo
谧	tfoa
贸	tfu
摩	tg
拇	tga
抿	tgae
描	tge
抹	tgee
摸	tgei
摹	tgeii
扪	tgo
旄	tgu
名	th
梦	the
秣	thee
弭	thei
孟	thi
秒	thiu
秘	tho
麋	thou
穆	thu
弥	thua
祢	thuai
吗	ti
买	tia
哞	tiao
蒙	tie
呒	tiee
唛	tieei
喵	tiei
黾	tii
嘛	tio
嘧	tioo
咪	tiou
咩	tioue
鸣	tiu
们	tj
侔	tja
命	tje
貘	tjei
貊	tjeu
觅	tji
貌	tju
仫	tjua
明	tk
猛	tka
犸	tkaa
猕	tkae
猸	tkai
猫	tke
昧	tkee
暮	tkei
冒	tki
曼	tkia
暝	tko
冕	tku
昴	tkua
鞔	tkuai
么	tl
卖	tla
坶	tlaa
默	tle
魅	tlee
墨	tlei
墓	tleii
埋	tli
墁	tlia
芈	tlie
魔	tlo
牟	tlu
耄	tluu
米	tm
妈	tma
姆	tmaa
媚	tmai
妹	tme
媒	tmei
嫫	tmeii
免	tmi
妙	tmiu
糜	tmo
嬷	tmoe
娩	tmu
敉	tmue
每	tn
鹛	tna
迈	tne
鹋	tnei
母	tno
迷	tnou
邈	tnu
没	to
湄	toa
泯	toae
满	toe
沫	toee
漠	toei
沔	toeia
漭	toeii
濛	toeiio
沐	toeiu
湎	toeu
漫	toi
渺	toia
汨	toiae
渑	toiaei
淼	toiau
泌	too
溟	tooa
浼	tou
泖	toua
马	tp
寐	tpa
冖	tpaa
宀	tpaaa
袂	tpae
寞	tpe
蓦	tpei
骂	tpi
冥	tpia
幂	tpiae
宓	tpo
殁	tpu
密	tq
嵋	tqa
岷	tqae
霉	tqu
峁	tqua
髦	tque
霾	tquo
玛	tr
珉	tra
艋	trai
艨	tre
瑁	tri
玫	tru
美	ts
膜	tse
皿	tsee
朦	tsei
腼	tseu
盟	tsi
脉	tso
脒	tsou
门	tt
码	tta
硭	tte
礞	ttei
闽	tti
磨	tto
闷	ttoa
闵	ttoe
毛	tu
毪	tua
篾	tui
某	tv
茅	tva
苠	tvae
荬	tvao
茂	tve
茉	tvee
莽	tveu
莫	tvi
苗	tvia
蔓	tviae
萌	tviaee
苜	tviaee2	2
蔑	tviai
甍	tviaii
瞢	tviaii2	2
末	tviu
茫	tvo
芒	tvoe
蘑	tvoeu
蘼	tvoeue
藐	tvu
茗	tvua
茆	tvuau
莓	tvue
慢	tw
勐	twa
愍	twae
慕	twe
劢	twea
募	twei
懵	tweii
懋	tweiu
忙	two
悯	twoi
懑	twoo
醚	twou
勉	twu
酩	twua
酶	twue
牧	tx
陌	txe
牡	txei
邙	txo
耱	txoe
卯	txu
牦	txue
目	ty
眉	tya
眠	tyae
眸	tyao
瞀	tyaoa
灭	tye
煤	tyei
眄	tyeia
睦	tyeie
瞒	tyeii
瞄	tyeiii
熳	tyi
眇	tyiu
盲	tyo
瞑	tyoa
焖	tyoi
眯	tyou
敏	tyu
幕	tz
颟	tze
帽	tzi
幔	tzia
鳗	tziae
鳘	tzu
铁	va
钛	vae
钍	vaei
铽	vaeo
铜	vai
钿	vaia
钽	vaiae
镗	vaio
锑	vao
铊	vaoo
铴	vaooe
锬	vaou
痛	vb
唐	vba
瘫	vbao
饧	vbau
田	vbe
饨	vbea
町	vbei
庹	vbeii
餮	vbeu
饕	vbi
痰	vbo
疃	vboe
庭	vbu
疼	vbua
畋	vbue
统	vc
厅	vce
躺	vci
缇	vcia
绨	vco
绦	vcu
梯	vd
桶	vda
椭	vdai
橐	vde
棠	vdi
桐	vdia
榻	vdiae
樘	vdio
檀	vdo
桃	vdu
梃	vdue
柝	vduu
屯	ve
螳	vei
蜕	veo
螗	veoe
蜓	veu
蜩	veua
谈	vf
讨	vfe
亠	vfee
谭	vfei
贴	vfi
亭	vfia
誊	vfo
贪	vfu
提	vg
抬	vga
摊	vgao
捅	vgaoi
拓	vge
抟	vgee
掭	vgeeu
挞	vgeu
探	vgo
搪	vgoe
推	vgu
投	vgua
彤	vguao
掏	vguau
托	vgue
拖	vguea
挺	vguei
挑	vguo
同	vh
团	vhe
凸	vhi
图	vhu
秃	vhua
祧	vhuo
头	vi
叹	via
嗵	viao
套	vie
吞	viee
吐	viei
嚏	vieio
鼍	vii
太	vio
啼	vioe
听	viu
啕	viua
唾	viue
他	vj
妥	vja
体	vje
仝	vjei
倘	vji
氽	vjia
傥	vjio
停	vjo
僮	vjoe
佗	vjoo
偷	vju
佟	vjua
倜	vjuae
佻	vjuo
替	vk
昙	vke
獭	vkei
暾	vko
条	vl
土	vle
坛	vlee
塔	vlei
填	vleii
台	vli
坦	vlia
塌	vliae
堂	vlio
塘	vlo
坨	vloo
坍	vlu
堍	vlua
她	vm
粜	vma
兔	vmi
剔	vmia
糖	vmo
婷	vmoe
剃	vmou
通	vn
退	vna
迢	vnau
童	vni
遢	vnia
鸵	vno
鹈	vnou
逃	vnu
逖	vnua
透	vnue
廷	vnuei
途	vnuo
泰	vo
汤	voa
滩	voao
添	voe
涛	voee
潭	voei
汀	voeii
汰	voeu
淌	voi
湍	voia
溻	voiae
涕	voo
潼	vooe
溏	vooeu
沱	vooo
涂	vou
淘	voua
沲	voue
滔	vouo
洮	vouoe
它	vp
褪	vpa
骀	vpao
驮	vpe
袒	vpi
裼	vpia
驼	vpo
殄	vpu
跳	vq
跆	vqa
髫	vqau
屠	vqe
屉	vqei
炭	vqeu
踏	vqi
踢	vqia
蹋	vqiae
蹄	vqo
跎	vqoo
霆	vqu
趿	vqua
韬	vquo
艇	vr
瑭	vro
彖	vru
突	vs
腿	vsa
臀	vsae
胎	vsao
豚	vse
肽	vseu
膛	vsi
腆	vsia
羰	vsiai
脱	vso
腾	vsou
滕	vsoue
窕	vsu
徒	vt
闼	vte
阗	vtei
碳	vti
砣	vto
砼	vtu
甜	vu
笤	vua
龆	vuau
舔	vue
乇	vuea
箨	vuei
筒	vui
趟	vuio
毯	vuo
鼗	vuoe
天	vv
苔	vva
薹	vve
荑	vvea
茼	vvi
萜	vvia
葶	vvo
藤	vvu
萄	vvua
菟	vvuai
莛	vvue
荼	vvuo
态	vw
忒	vwe
恸	vwee
慝	vweei
忝	vweeu
忑	vwei
酞	vweu
惕	vwi
酮	vwia
覃	vwiae
醍	vwiaee
忐	vwie
悌	vwo
醣	vwoe
酡	vwoo
恬	vwu
骰	vwua
酴	vwuo
特	vx
邰	vxa
耥	vxi
陀	vxo
郯	vxou
陶	vxu
烫	vy
烃	vya
煺	vyae
炱	vyao
瞳	vyo
眺	vyu
题	vz
帑	vza
鲐	vzao
帖	vzi
鳎	vzia
颓	vzu
鲦	vzua
幻	wa
镬	wae
镐	wao
钬	waou
铧	wau
锪	waua
铪	wauo
锾	wauoo
户	wb
痕	wba
癀	wbe
扈	wbi
馄	wbia
戽	wbo
痪	wbu
瘊	wbui
红	wc
厚	wci
缋	wcia
缳	wciai
氦	wco
缓	wcu
纥	wcue
绘	wcuo
绗	wcuu
欢	wd
横	wde
桓	wdei
核	wdo
杭	wdoe
槐	wdu
槲	wdua
桦	wdui
桁	wduu
或	we
互	wea
虹	wee
蝴	weei
蟪	weeia
蚵	weeiae
蠖	weeii
蚶	weeiie
蟥	weeiie2	2
虺	weeu
画	wei
蛔	weia
蝗	weu
蚝	weue
蛤	weuo
话	wf
贺	wfa
亥	wfau
谎	wfe
讳	wfee
诃	wfei
讧	wfeie
贿	wfeu
诙	wfeuo
毫	wfi
豪	wfia
亨	wfiae
诨	wfo
货	wfu
诲	wfue
护	wg
撖	wga
撼	wge
攉	wgeo
捍	wgi
擐	wgia
挥	wgo
换	wgu
和	wh
函	wha
弘	whao
祜	whe
觳	whei
回	whi
祸	whia
夥	whiae
秽	whiai
圜	whiaii
孩	who
禾	whoo
毁	whu
囫	whua
凰	whui
弧	whuu
后	wi
吼	wia
喙	wiaa
夯	wiau
号	wie
呵	wiei
哄	wieii
嚆	wieiio
嗬	wieiiu
嚯	wieo
喊	wieu
咴	wieuo
划	wii
喝	wiia
嘿	wiiao
唬	wiie
哼	wio
咳	wioe
嚎	wioei
嗨	wioo
豢	wiou
哈	wiu
唤	wiua
唿	wiuau
喉	wiui
嗥	wiuia
哗	wiuiu
呼	wiuo
会	wj
侯	wja
合	wje
何	wjei
盒	wjeia
瓠	wjeu
候	wji
含	wjo
伙	wjou
化	wju
貉	wjua
皇	wk
轰	wka
狠	wkae
旱	wke
昊	wkee
荤	wkei
獾	wkeii
猢	wkeiia
晃	wki
猾	wkia
晖	wko
昏	wku
曷	wkua
皓	wkue
晦	wkuea
猴	wkui
晗	wkuo
轷	wkuou
狐	wkuu
华	wl
坏	wle
魂	wlee
卉	wleu
翰	wli
壑	wlie
黑	wlo
壶	wloa
壕	wloe
堠	wlu
好	wm
糊	wme
劐	wmei
奂	wmi
嬛	wmia
婚	wmu
糇	wmui
还	wn
鹕	wne
鹱	wnei
鹤	wno
逭	wnoo
鹄	wnu
遑	wnui
逅	wnuu
海	wo
汉	woa
泓	woae
涵	woai
河	woe
汇	woea
汗	woee
湖	woei
洹	woeia
鸿	woeie
洪	woeii
瀚	woeiia
潢	woeiie
混	woi
滑	woia
涸	woiae
灏	woiaee
漶	woiaei
溷	woiaeu
洄	woiai
滹	woie
浑	woo
沪	wooa
浒	wooau
濠	wooe
沆	wooeu
浣	wooo
活	wou
涣	woua
浩	woue
淮	woui
湟	wouia
浍	wouo
害	wp
寒	wpe
豁	wpee
宦	wpei
宏	wpeu
褐	wpi
寰	wpia
骇	wpo
罕	wpu
骅	wpui
韩	wq
岵	wqe
踝	wqi
鬟	wqia
霍	wqu
黄	wr
环	wre
彗	wree
瑚	wrei
璜	wreii
琥	wri
航	wro
珲	wroa
珩	wru
胡	ws
虍	wsa
辉	wse
盍	wsei
肓	wso
鲎	wsoa
黉	wsoae
胲	wsoe
虎	wsu
很	wt
後	wta
磺	wte
砉	wtee
阖	wtei
闳	wteu
徽	wti
徊	wtia
阂	wto
訇	wtoe
衡	wtu
阍	wtua
徨	wtui
乎	wu
簧	wue
麾	wuo
笏	wuu
篁	wuui
篌	wuuia
花	wv
荭	wva
菡	wvai
薅	wvau
葫	wve
蕙	wvei
蕻	wveie
藿	wveo
茴	wvi
薨	wvia
荒	wvo
蒿	wvoe
斛	wvoo
菏	wvooe
获	wvu
荷	wvui
萑	wvuio
荟	wvuo
蘅	wvuu
怀	ww
恨	wwa
憨	wwae
隳	wwai
恢	wwe
慧	wwee
惠	wwei
惑	wweia
恒	wweiae
恚	wweie
慌	wweii
怙	wweiia
醐	wweiia2	2
酣	wweiie
憾	wweu
醢	wweui
患	wwi
悍	wwia
恍	wwio
骸	wwo
劾	wwoe
忽	wwu
惚	wwua
悔	wwue
惶	wwui
骺	wwuu
耗	wx
鼾	wxe
邗	wxee
邯	wxei
隍	wxu
郇	wxua
齁	wxuai
耠	wxuo
火	wy
灰	wye
烘	wyei
煳	wyeii
焊	wyi
煌	wyu
焕	wyua
烩	wyuo
焓	wyuoo
烀	wyuou
赫	wz
郝	wza
冱	wze
顸	wzee
翮	wzei
幌	wzi
颢	wzia
颃	wzo
鲩	wzoo
颌	wzu
鳇	wzui
颔	wzuo
乃	xa
钮	xaa
铌	xaae
钕	xaau
镊	xae
铙	xaea
锘	xaei
钠	xai
镍	xau
鼐	xaui
镎	xauo
男	xb
疟	xbe
疒	xbee
馕	xbei
馁	xbu
纳	xc
纽	xca
氖	xcau
耐	xce
难	xd
楠	xde
柰	xdee
柠	xdo
囊	xe
蛲	xee
蝻	xeei
孬	xeu
诺	xf
讷	xfi
拟	xg
扭	xga
挪	xgae
搦	xgaea
挠	xge
撵	xgee
攮	xgei
捺	xgeu
捏	xgi
拈	xgie
拧	xgo
捻	xgu
旎	xgue
内	xh
弩	xha
衄	xhai
囡	xhau
孥	xhaue
匿	xhe
黏	xhu
呢	xi
哪	xia
呶	xiau
奈	xie
喃	xiei
囔	xieia
嗫	xieii
喏	xieiie
呐	xii
啮	xiie
哝	xio
咛	xioo
你	xj
傩	xja
伲	xjae
拿	xje
佞	xjee
侬	xjo
倪	xju
暖	xk
昵	xka
狃	xkai
猱	xkao
辇	xke
狞	xko
曩	xkoe
猊	xku
能	xl
坭	xla
南	xli
垴	xlo
埝	xlu
女	xm
奶	xma
娜	xmae
妮	xmaeu
妞	xmai
奴	xmao
胬	xmaoi
嫩	xme
糯	xmeo
嬲	xmi
娘	xmo
鸟	xn
逆	xno
泥	xo
溺	xoa
臬	xoe
涅	xoi
淖	xoie
浓	xoo
泞	xooo
农	xp
驽	xpa
宁	xpe
衲	xpi
甯	xpo
袅	xpu
尼	xq
蹑	xqe
尿	xqi
霓	xqu
弄	xr
瑙	xra
脑	xs
脲	xsa
虐	xse
腻	xsee
腩	xsei
肭	xsi
脓	xso
闹	xt
碾	xta
硇	xtu
年	xu
孽	xv
艿	xva
廿	xve
蔫	xvei
萘	xveu
茑	xvu
蘖	xvui
念	xw
努	xwa
怩	xwae
忸	xwai
怒	xwau
懦	xwe
恧	xweu
恼	xwo
酿	xwoa
您	xwu
恁	xwui
那	xx
聂	xxa
耨	xxe
牛	xxi
陧	xxia
聍	xxo
睨	xy
凝	xz
赧	xza
颞	xze
鲇	xzi
鲶	xzu
鲵	xzui
铺	ya
铍	yaa
钷	yae
钋	yai
镤	yaii
锫	yao
镨	yaou
疲	yb
癖	yba
庞	ybe
毗	ybea
痞	ybeu
畔	ybo
疱	ybu
庖	ybua
庀	ybuaa
片	yc
缥	yce
纰	ycea
牌	ycu
氕	ycuu
朴	yd
杷	yda
枰	yde
枇	ydea
榀	ydi
疋	ydo
棚	ydu
平	ye
辟	yea
蟛	yee
蚍	yeea
罴	yeei
螵	yeeia
螃	yeo
丕	yeu
蜱	yeui
蟠	yeuo
评	yf
譬	yfa
烹	yfi
旁	yfo
谝	yfoa
赔	yfoe
谱	yfou
贫	yfu
裒	yfui
批	yg
披	yga
擗	ygae
拚	ygao
彭	yge
捧	ygee
攀	ygei
抨	ygeo
排	ygi
扑	ygio
拼	ygo
掊	ygoe
撇	ygou
拍	ygu
抛	ygua
旆	ygue
凭	yh
圃	yhe
叵	yhi
匹	yhu
爿	yhuu
品	yi
噼	yia
辔	yiaa
喷	yie
匏	yiee
啪	yiei
嘌	yieia
嘭	yieie
呸	yieu
噗	yii
啤	yiu
咆	yiua
哌	yiuu
偏	yj
爬	yja
僻	yjae
瓢	yje
仳	yjea
仆	yji
俜	yjia
俳	yjie
佩	yju
貔	yjui
魄	yk
曝	yki
攴	yko
狍	yku
皤	ykuo
培	yl
坡	yla
圮	ylae
坪	yle
埔	ylei
坯	yleu
颦	yli
鼙	ylia
堋	ylu
埤	ylui
判	ym
劈	yma
嫖	yme
剽	ymei
娉	ymi
婆	ymo
剖	ymoe
嫔	ymoo
姘	ymou
刨	ymu
媲	ymui
粕	ymuia
迫	yn
鹏	ynu
逄	ynua
派	yo
泼	yoa
漂	yoe
浦	yoei
沛	yoeia
溥	yoeiae
澎	yoeie
瀑	yoi
淠	yoia
滂	yoo
泮	yoou
泡	you
湃	youe
泊	youi
濮	youii
潘	youo
湓	youoa
骗	yp
襻	ype
裴	ypi
骈	ypo
袢	ypou
袍	ypu
殍	ypuo
跑	yq
霹	yqa
屁	yqe
蹒	yqei
蹼	yqi
屏	yqo
蹁	yqoa
霈	yqoo
趴	yqu
普	yr
甓	yra
叛	yre
琶	yree
盘	yri
璞	yrii
瓶	yro
珀	yru
朋	ys
膨	yse
琵	ysee
脯	ysei
胚	yseu
胖	yso
胼	ysou
盆	ysu
脾	ysui
脬	ysuo
破	yt
砰	yte
砒	ytea
匍	ytei
徘	yti
碰	yto
彷	ytoe
磐	ytu
硼	ytua
篇	yu
笸	yue
筢	yuei
乒	yui
乓	yuie
氆	yuo
篷	yuu
丿	yuuu
皮	yv
颇	yve
芘	yvea
莆	yvei
苹	yveo
苤	yveu
萍	yvo
菩	yvoe
蒲	yvoo
蒎	yvooe
葡	yvu
蓬	yvua
葩	yvui
怕	yw
配	ywa
票	ywe
怦	yweo
醅	ywo
飘	yx
邳	yxe
聘	yxi
陪	yxo
犏	yxoa
耪	yxoe
鄱	yxu
牝	yxua
郫	yxui
陴	yxuia
炮	yy
瞟	yye
瞥	yyo
攵	yyoo
盼	yyu
睥	yyui
帕	yz
帔	yza
鲆	yze
频	yzi
翩	yzo
承	za
钗	zaa
铖	zae
丑	zai
锄	zaia
钞	zaiu
铲	zao
铳	zaoe
镲	zaoo
锤	zau
锸	zaue
钏	zaui
床	zb
巛	zba
瘳	zbao
畴	zbe
瘛	zbee
馇	zbei
巢	zbi
廛	zbia
畜	zbo
瘥	zbou
痴	zbu
馋	zbua
饬	zbue
疮	zbuo
厂	zc
绌	zca
纯	zce
厨	zcei
绰	zci
缠	zco
绸	zcu
氚	zcui
查	zd
橙	zda
椽	zdaa
杈	zdao
柽	zdaoe
楚	zde
椿	zdee
楮	zdei
樗	zdeo
橱	zdeu
柴	zdi
叉	zdo
榇	zdoe
檫	zdoo
槎	zdou
椎	zdu
杵	zdue
枨	zduea
棰	zduei
槌	zdui
虫	ze
丞	zea
蚩	zeai
蛏	zeao
蠢	zee
虿	zeea
蝽	zeee
蝉	zeo
雠	zeoa
螭	zeoe
雏	zeu
蟾	zeua
蜍	zeuo
充	zf
诚	zfe
谌	zfei
诧	zfo
谄	zfu
谗	zfua
谶	zfuo
持	zg
搽	zge
抽	zgi
揣	zgia
抻	zgiae
扯	zgie
觇	zgiei
撑	zgio
抄	zgiu
撤	zgo
搐	zgoe
插	zgu
搀	zgua
捶	zgue
掣	zguee
拆	zguu
搋	zguui
程	zh
弛	zha
秤	zhe
舛	zhea
臣	zhi
唇	zhia
禅	zho
辰	zhoo
称	zhu
稠	zhua
鬯	zhuo
成	zi
戳	zia
啜	ziao
呈	zie
嘲	ziei
哧	zieie
嗔	zieii
唱	zii
串	ziia
嘬	ziiae
喘	ziiai
嗤	ziiaie
吵	ziiu
啻	zio
吃	ziu
吹	ziua
叱	ziuaa
传	zj
豺	zje
俦	zjee
偿	zji
倡	zjia
储	zjo
侪	zjoe
仇	zju
侈	zjua
傺	zjuao
伥	zjue
车	zk
辍	zka
春	zke
舂	zkee
猹	zkei
晨	zkeu
晟	zkeua
昌	zki
畅	zkia
猖	zkiae
昶	zko
晁	zku
处	zl
场	zla
墀	zlae
黜	zlai
城	zle
矗	zli
埕	zlia
斥	zlo
魑	zloe
坻	zlu
坼	zluu
创	zm
刍	zma
媸	zmai
嫦	zmi
娼	zmia
婵	zmo
姹	zmoo
产	zn
迟	zna
逞	zni
遄	znia
鹑	zno
辶	znoo
鸱	znu
沉	zo
池	zoa
潺	zoae
滁	zoai
澄	zoao
汊	zoaoo
潮	zoe
臭	zoeu
淳	zoo
澈	zooe
澶	zooei
察	zp
初	zpa
骣	zpae
驰	zpai
衩	zpao
宠	zpe
衬	zpei
褚	zpeie
宸	zpeu
骋	zpi
裎	zpia
褫	zpu
尺	zq
踌	zqe
躇	zqei
蹰	zqeu
踹	zqi
踔	zqie
崇	zqo
躔	zqoe
羼	zqou
岔	zqu
踟	zque
船	zr
舡	zre
冁	zri
琛	zro
艟	zroe
朝	zs
肠	zsa
差	zse
穿	zsea
尘	zsei
尝	zso
膪	zsoe
塍	zsou
窗	zsu
础	zt
闯	zta
碜	ztao
彻	zte
砗	ztea
碴	ztei
徜	zti
阊	ztia
彳	ztii
阐	zto
超	zu
笞	zua
乘	zue
筹	zuee
川	zui
龊	zuia
齿	zuii
氅	zuio
趁	zuu
龀	zuua
篪	zuuu
出	zv
莼	zva
茬	zve
蒇	zveu
触	zvi
菖	zvia
亍	zvii
屮	zviii
茺	zvo
茶	zvu
垂	zvue
苌	zvuea
茌	zvui
惩	zw
怊	zwa
怵	zwe
憷	zwei
忡	zwi
酲	zwia
惝	zwio
酬	zwo
忱	zwoa
醇	zwoe
憧	zwoeo
愁	zwu
惆	zwua
忏	zwue
怅	zwuea
怆	zwuo
除	zx
陈	zxe
郴	zxei
耻	zxi
耖	zxiu
陲	zxu
炒	zy
敕	zye
敞	zyi
炽	zyia
焯	zyie
瞠	zyio
瞅	zyu
炊	zyua
眵	zyuao
常	zz
翅	zze
帱	zzee
冲	zzi
鲳	zzia
赤	zzo
颤	zzoe
幢	zzoeo
